"player_id","round","score","start_price","end_price","change"
240283,1,81,828000,817000,-11000
240283,2,85,817000,803000,-14000
240283,3,77,803000,781000,-22000
240283,4,50,781000,738000,-43000
240283,5,NA,738000,738000,0
240283,6,NA,738000,738000,0
240283,7,60,738000,693000,-45000
240283,8,91,693000,674000,-19000
240283,9,NA,674000,674000,0
240283,10,NA,674000,674000,0
240283,11,109,674000,684000,10000
240283,12,22,684000,651000,-33000
240283,13,NA,651000,651000,0
240283,14,NA,651000,651000,0
240283,15,NA,651000,651000,0
240283,16,133,651000,676000,25000
240283,17,NA,676000,676000,0
240283,18,58,676000,676000,0
240283,19,99,676000,687000,11000
240283,20,86,687000,696000,9000
240283,21,NA,696000,696000,0
240283,22,NA,696000,696000,0
240283,23,NA,696000,696000,0
240283,24,89,696000,706000,10000
240399,1,41,630000,607000,-23000
240399,2,NA,607000,607000,0
240399,3,62,607000,583000,-24000
240399,4,14,583000,528000,-55000
240399,5,NA,528000,528000,0
240399,6,NA,528000,528000,0
240399,7,78,528000,506000,-22000
240399,8,61,506000,497000,-9000
240399,9,23,497000,469000,-28000
240399,10,93,469000,480000,11000
240399,11,23,480000,467000,-13000
240399,12,NA,467000,467000,0
240399,13,33,467000,440000,-27000
240399,14,NA,440000,440000,0
240399,15,NA,440000,440000,0
240399,16,NA,440000,440000,0
240399,17,80,440000,444000,4000
240399,18,79,444000,468000,24000
240399,19,72,468000,492000,24000
240399,20,8,492000,476000,-16000
240399,21,NA,476000,476000,0
240399,22,NA,476000,476000,0
240399,23,NA,476000,476000,0
240399,24,NA,476000,476000,0
250365,1,NA,841000,841000,0
250365,2,30,841000,791000,-50000
250365,3,48,791000,722000,-69000
250365,4,70,722000,667000,-55000
250365,5,73,667000,632000,-35000
250365,6,76,632000,619000,-13000
250365,7,124,619000,654000,35000
250365,8,73,654000,677000,23000
250365,9,56,677000,673000,-4000
250365,10,42,673000,642000,-31000
250365,11,NA,642000,642000,0
250365,12,NA,642000,642000,0
250365,13,88,642000,628000,-14000
250365,14,52,628000,604000,-24000
250365,15,NA,604000,604000,0
250365,16,42,604000,570000,-34000
250365,17,74,570000,556000,-14000
250365,18,63,556000,548000,-8000
250365,19,64,548000,542000,-6000
250365,20,27,542000,514000,-28000
250365,21,71,514000,506000,-8000
250365,22,NA,506000,506000,0
250365,23,37,506000,483000,-23000
250365,24,71,483000,477000,-6000
250395,1,76,552000,561000,9000
250395,2,56,561000,561000,0
250395,3,38,561000,541000,-20000
250395,4,NA,541000,541000,0
250395,5,65,541000,529000,-12000
250395,6,73,529000,530000,1000
250395,7,32,530000,508000,-22000
250395,8,65,508000,501000,-7000
250395,9,72,501000,507000,6000
250395,10,38,507000,494000,-13000
250395,11,22,494000,461000,-33000
250395,12,105,461000,477000,16000
250395,13,67,477000,494000,17000
250395,14,41,494000,495000,1000
250395,15,NA,495000,495000,0
250395,16,17,495000,469000,-26000
250395,17,43,469000,442000,-27000
250395,18,80,442000,440000,-2000
250395,19,55,440000,443000,3000
250395,20,48,443000,445000,2000
250395,21,63,445000,457000,12000
250395,22,35,457000,449000,-8000
250395,23,63,449000,448000,-1000
250395,24,NA,448000,448000,0
260257,1,118,752000,775000,23000
260257,2,74,775000,781000,6000
260257,3,72,781000,770000,-11000
260257,4,89,770000,760000,-10000
260257,5,85,760000,751000,-9000
260257,6,85,751000,743000,-8000
260257,7,NA,743000,743000,0
260257,8,92,743000,743000,0
260257,9,37,743000,708000,-35000
260257,10,103,708000,700000,-8000
260257,11,102,700000,708000,8000
260257,12,83,708000,713000,5000
260257,13,92,713000,723000,10000
260257,14,NA,723000,723000,0
260257,15,76,723000,727000,4000
260257,16,84,727000,726000,-1000
260257,17,93,726000,727000,1000
260257,18,68,727000,715000,-12000
260257,19,83,715000,707000,-8000
260257,20,81,707000,700000,-7000
260257,21,106,700000,713000,13000
260257,22,102,713000,732000,19000
260257,23,122,732000,771000,39000
260257,24,89,771000,790000,19000
261224,1,NA,731000,731000,0
261224,2,116,731000,753000,22000
261224,3,62,753000,751000,-2000
261224,4,58,751000,727000,-24000
261224,5,110,727000,729000,2000
261224,6,83,729000,729000,0
261224,7,73,729000,718000,-11000
261224,8,NA,718000,718000,0
261224,9,109,718000,732000,14000
261224,10,58,732000,721000,-11000
261224,11,78,721000,707000,-14000
261224,12,NA,707000,707000,0
261224,13,NA,707000,707000,0
261224,14,NA,707000,707000,0
261224,15,NA,707000,707000,0
261224,16,NA,707000,707000,0
261224,17,55,707000,679000,-28000
261224,18,65,679000,650000,-29000
261224,19,75,650000,630000,-20000
261224,20,84,630000,628000,-2000
261224,21,109,628000,652000,24000
261224,22,83,652000,674000,22000
261224,23,103,674000,704000,30000
261224,24,121,704000,745000,41000
261510,1,59,680000,666000,-14000
261510,2,30,666000,621000,-45000
261510,3,24,621000,556000,-65000
261510,4,87,556000,531000,-25000
261510,5,94,531000,543000,12000
261510,6,67,543000,559000,16000
261510,7,137,559000,624000,65000
261510,8,68,624000,662000,38000
261510,9,62,662000,670000,8000
261510,10,65,670000,660000,-10000
261510,11,34,660000,620000,-40000
261510,12,57,620000,578000,-42000
261510,13,NA,578000,578000,0
261510,14,49,578000,544000,-34000
261510,15,48,544000,513000,-31000
261510,16,69,513000,503000,-10000
261510,17,73,503000,510000,7000
261510,18,110,510000,551000,41000
261510,19,36,551000,557000,6000
261510,20,40,557000,543000,-14000
261510,21,NA,543000,543000,0
261510,22,NA,543000,543000,0
261510,23,51,543000,521000,-22000
261510,24,NA,521000,521000,0
270146,1,74,552000,560000,8000
270146,2,103,560000,594000,34000
270146,3,42,594000,597000,3000
270146,4,65,597000,593000,-4000
270146,5,107,593000,617000,24000
270146,6,24,617000,597000,-20000
270146,7,67,597000,579000,-18000
270146,8,62,579000,566000,-13000
270146,9,6,566000,514000,-52000
270146,10,72,514000,488000,-26000
270146,11,55,488000,475000,-13000
270146,12,NA,475000,475000,0
270146,13,42,475000,457000,-18000
270146,14,NA,457000,457000,0
270146,15,NA,457000,457000,0
270146,16,68,457000,460000,3000
270146,17,NA,460000,460000,0
270146,18,NA,460000,460000,0
270146,19,61,460000,469000,9000
270146,20,NA,469000,469000,0
270146,21,10,469000,441000,-28000
270146,22,17,441000,399000,-42000
270146,23,21,399000,354000,-45000
270146,24,NA,354000,354000,0
270325,1,NA,357000,357000,0
270325,2,NA,357000,357000,0
270325,3,NA,357000,357000,0
270325,4,NA,357000,357000,0
270325,5,NA,357000,357000,0
270325,6,NA,357000,357000,0
270325,7,NA,357000,357000,0
270325,8,NA,357000,357000,0
270325,9,NA,357000,357000,0
270325,10,NA,357000,357000,0
270325,11,NA,357000,357000,0
270325,12,NA,357000,357000,0
270325,13,NA,357000,357000,0
270325,14,NA,357000,357000,0
270325,15,NA,357000,357000,0
270325,16,NA,357000,357000,0
270325,17,NA,357000,357000,0
270325,18,NA,357000,357000,0
270325,19,NA,357000,357000,0
270325,20,NA,357000,357000,0
270325,21,NA,357000,357000,0
270325,22,NA,357000,357000,0
270325,23,NA,357000,357000,0
270325,24,NA,357000,357000,0
270896,1,57,701000,683000,-18000
270896,2,59,683000,656000,-27000
270896,3,80,656000,641000,-15000
270896,4,38,641000,605000,-36000
270896,5,24,605000,552000,-53000
270896,6,62,552000,520000,-32000
270896,7,52,520000,495000,-25000
270896,8,NA,495000,495000,0
270896,9,61,495000,482000,-13000
270896,10,60,482000,481000,-1000
270896,11,42,481000,473000,-8000
270896,12,65,473000,474000,1000
270896,13,93,474000,500000,26000
270896,14,119,500000,562000,62000
270896,15,NA,562000,562000,0
270896,16,51,562000,590000,28000
270896,17,54,590000,595000,5000
270896,18,56,595000,584000,-11000
270896,19,62,584000,567000,-17000
270896,20,38,567000,533000,-34000
270896,21,NA,533000,533000,0
270896,22,NA,533000,533000,0
270896,23,70,533000,519000,-14000
270896,24,NA,519000,519000,0
270917,1,66,674000,665000,-9000
270917,2,86,665000,666000,1000
270917,3,92,666000,677000,11000
270917,4,104,677000,703000,26000
270917,5,82,703000,719000,16000
270917,6,110,719000,750000,31000
270917,7,93,750000,769000,19000
270917,8,68,769000,763000,-6000
270917,9,NA,763000,763000,0
270917,10,NA,763000,763000,0
270917,11,NA,763000,763000,0
270917,12,NA,763000,763000,0
270917,13,NA,763000,763000,0
270917,14,66,763000,743000,-20000
270917,15,NA,743000,743000,0
270917,16,47,743000,699000,-44000
270917,17,101,699000,682000,-17000
270917,18,54,682000,654000,-28000
270917,19,94,654000,652000,-2000
270917,20,51,652000,636000,-16000
270917,21,84,636000,634000,-2000
270917,22,95,634000,644000,10000
270917,23,41,644000,628000,-16000
270917,24,104,628000,635000,7000
270963,1,68,622000,619000,-3000
270963,2,50,619000,602000,-17000
270963,3,60,602000,582000,-20000
270963,4,83,582000,581000,-1000
270963,5,82,581000,592000,11000
270963,6,111,592000,632000,40000
270963,7,85,632000,665000,33000
270963,8,89,665000,693000,28000
270963,9,97,693000,719000,26000
270963,10,78,719000,726000,7000
270963,11,75,726000,720000,-6000
270963,12,58,720000,695000,-25000
270963,13,94,695000,686000,-9000
270963,14,NA,686000,686000,0
270963,15,55,686000,664000,-22000
270963,16,112,664000,676000,12000
270963,17,74,676000,681000,5000
270963,18,57,681000,668000,-13000
270963,19,82,668000,661000,-7000
270963,20,60,661000,645000,-16000
270963,21,57,645000,618000,-27000
270963,22,63,618000,596000,-22000
270963,23,50,596000,570000,-26000
270963,24,NA,570000,570000,0
271045,1,NA,708000,708000,0
271045,2,NA,708000,708000,0
271045,3,NA,708000,708000,0
271045,4,NA,708000,708000,0
271045,5,NA,708000,708000,0
271045,6,NA,708000,708000,0
271045,7,NA,708000,708000,0
271045,8,NA,708000,708000,0
271045,9,NA,708000,708000,0
271045,10,NA,708000,708000,0
271045,11,NA,708000,708000,0
271045,12,NA,708000,708000,0
271045,13,NA,708000,708000,0
271045,14,NA,708000,708000,0
271045,15,NA,708000,708000,0
271045,16,NA,708000,708000,0
271045,17,NA,708000,708000,0
271045,18,NA,708000,708000,0
271045,19,NA,708000,708000,0
271045,20,NA,708000,708000,0
271045,21,NA,708000,708000,0
271045,22,NA,708000,708000,0
271045,23,NA,708000,708000,0
271045,24,NA,708000,708000,0
271072,1,89,747000,749000,2000
271072,2,48,749000,723000,-26000
271072,3,NA,723000,723000,0
271072,4,NA,723000,723000,0
271072,5,47,723000,677000,-46000
271072,6,97,677000,661000,-16000
271072,7,88,661000,661000,0
271072,8,NA,661000,661000,0
271072,9,NA,661000,661000,0
271072,10,NA,661000,661000,0
271072,11,91,661000,670000,9000
271072,12,NA,670000,670000,0
271072,13,52,670000,661000,-9000
271072,14,NA,661000,661000,0
271072,15,NA,661000,661000,0
271072,16,NA,661000,661000,0
271072,17,NA,661000,661000,0
271072,18,NA,661000,661000,0
271072,19,NA,661000,661000,0
271072,20,NA,661000,661000,0
271072,21,NA,661000,661000,0
271072,22,NA,661000,661000,0
271072,23,NA,661000,661000,0
271072,24,NA,661000,661000,0
271129,1,NA,634000,634000,0
271129,2,45,634000,613000,-21000
271129,3,85,613000,607000,-6000
271129,4,82,607000,612000,5000
271129,5,60,612000,609000,-3000
271129,6,81,609000,615000,6000
271129,7,55,615000,608000,-7000
271129,8,100,608000,622000,14000
271129,9,128,622000,669000,47000
271129,10,96,669000,712000,43000
271129,11,81,712000,735000,23000
271129,12,78,735000,742000,7000
271129,13,58,742000,720000,-22000
271129,14,102,720000,717000,-3000
271129,15,NA,717000,717000,0
271129,16,37,717000,681000,-36000
271129,17,NA,681000,681000,0
271129,18,NA,681000,681000,0
271129,19,92,681000,666000,-15000
271129,20,79,666000,659000,-7000
271129,21,82,659000,660000,1000
271129,22,28,660000,625000,-35000
271129,23,51,625000,589000,-36000
271129,24,46,589000,546000,-43000
280078,1,118,754000,777000,23000
280078,2,60,777000,772000,-5000
280078,3,28,772000,723000,-49000
280078,4,NA,723000,723000,0
280078,5,NA,723000,723000,0
280078,6,62,723000,674000,-49000
280078,7,NA,674000,674000,0
280078,8,NA,674000,674000,0
280078,9,NA,674000,674000,0
280078,10,NA,674000,674000,0
280078,11,NA,674000,674000,0
280078,12,NA,674000,674000,0
280078,13,53,674000,622000,-52000
280078,14,NA,622000,622000,0
280078,15,120,622000,625000,3000
280078,16,109,625000,658000,33000
280078,17,NA,658000,658000,0
280078,18,64,658000,675000,17000
280078,19,11,675000,637000,-38000
280078,20,NA,637000,637000,0
280078,21,NA,637000,637000,0
280078,22,NA,637000,637000,0
280078,23,NA,637000,637000,0
280078,24,101,637000,626000,-11000
280109,1,95,712000,722000,10000
280109,2,65,722000,715000,-7000
280109,3,79,715000,707000,-8000
280109,4,80,707000,700000,-7000
280109,5,81,700000,695000,-5000
280109,6,38,695000,661000,-34000
280109,7,NA,661000,661000,0
280109,8,42,661000,616000,-45000
280109,9,16,616000,547000,-69000
280109,10,44,547000,489000,-58000
280109,11,64,489000,461000,-28000
280109,12,134,461000,505000,44000
280109,13,95,505000,562000,57000
280109,14,43,562000,589000,27000
280109,15,NA,589000,589000,0
280109,16,54,589000,593000,4000
280109,17,77,593000,593000,0
280109,18,55,593000,575000,-18000
280109,19,81,575000,573000,-2000
280109,20,79,573000,583000,10000
280109,21,105,583000,616000,33000
280109,22,88,616000,647000,31000
280109,23,116,647000,693000,46000
280109,24,50,693000,695000,2000
280317,1,75,607000,611000,4000
280317,2,59,611000,605000,-6000
280317,3,NA,605000,605000,0
280317,4,71,605000,600000,-5000
280317,5,67,600000,596000,-4000
280317,6,NA,596000,596000,0
280317,7,NA,596000,596000,0
280317,8,NA,596000,596000,0
280317,9,NA,596000,596000,0
280317,10,NA,596000,596000,0
280317,11,NA,596000,596000,0
280317,12,NA,596000,596000,0
280317,13,NA,596000,596000,0
280317,14,NA,596000,596000,0
280317,15,47,596000,576000,-20000
280317,16,63,576000,560000,-16000
280317,17,97,560000,573000,13000
280317,18,63,573000,578000,5000
280317,19,64,578000,579000,1000
280317,20,72,579000,584000,5000
280317,21,105,584000,611000,27000
280317,22,80,611000,630000,19000
280317,23,NA,630000,630000,0
280317,24,64,630000,633000,3000
280506,1,34,683000,650000,-33000
280506,2,87,650000,635000,-15000
280506,3,50,635000,608000,-27000
280506,4,54,608000,580000,-28000
280506,5,89,580000,581000,1000
280506,6,123,581000,626000,45000
280506,7,37,626000,627000,1000
280506,8,34,627000,600000,-27000
280506,9,99,600000,603000,3000
280506,10,NA,603000,603000,0
280506,11,48,603000,584000,-19000
280506,12,53,584000,558000,-26000
280506,13,166,558000,618000,60000
280506,14,NA,618000,618000,0
280506,15,97,618000,677000,59000
280506,16,87,677000,717000,40000
280506,17,65,717000,728000,11000
280506,18,53,728000,707000,-21000
280506,19,62,707000,669000,-38000
280506,20,131,669000,682000,13000
280506,21,72,682000,686000,4000
280506,22,98,686000,704000,18000
280506,23,65,704000,704000,0
280506,24,164,704000,756000,52000
280711,1,86,601000,613000,12000
280711,2,85,613000,633000,20000
280711,3,79,633000,650000,17000
280711,4,64,650000,650000,0
280711,5,82,650000,654000,4000
280711,6,NA,654000,654000,0
280711,7,46,654000,632000,-22000
280711,8,79,632000,621000,-11000
280711,9,NA,621000,621000,0
280711,10,NA,621000,621000,0
280711,11,NA,621000,621000,0
280711,12,NA,621000,621000,0
280711,13,79,621000,616000,-5000
280711,14,39,616000,595000,-21000
280711,15,NA,595000,595000,0
280711,16,78,595000,587000,-8000
280711,17,77,587000,588000,1000
280711,18,NA,588000,588000,0
280711,19,61,588000,582000,-6000
280711,20,85,582000,591000,9000
280711,21,NA,591000,591000,0
280711,22,NA,591000,591000,0
280711,23,NA,591000,591000,0
280711,24,NA,591000,591000,0
280737,1,68,573000,574000,1000
280737,2,87,574000,591000,17000
280737,3,58,591000,594000,3000
280737,4,70,594000,595000,1000
280737,5,77,595000,602000,7000
280737,6,41,602000,584000,-18000
280737,7,108,584000,600000,16000
280737,8,128,600000,652000,52000
280737,9,74,652000,683000,31000
280737,10,64,683000,690000,7000
280737,11,NA,690000,690000,0
280737,12,80,690000,692000,2000
280737,13,81,692000,686000,-6000
280737,14,69,686000,674000,-12000
280737,15,NA,674000,674000,0
280737,16,30,674000,633000,-41000
280737,17,NA,633000,633000,0
280737,18,109,633000,631000,-2000
280737,19,93,631000,644000,13000
280737,20,NA,644000,644000,0
280737,21,NA,644000,644000,0
280737,22,NA,644000,644000,0
280737,23,NA,644000,644000,0
280737,24,NA,644000,644000,0
280744,1,73,514000,524000,10000
280744,2,60,524000,531000,7000
280744,3,32,531000,514000,-17000
280744,4,88,514000,522000,8000
280744,5,56,522000,524000,2000
280744,6,36,524000,506000,-18000
280744,7,56,506000,494000,-12000
280744,8,NA,494000,494000,0
280744,9,44,494000,477000,-17000
280744,10,90,477000,488000,11000
280744,11,74,488000,508000,20000
280744,12,90,508000,544000,36000
280744,13,46,544000,554000,10000
280744,14,NA,554000,554000,0
280744,15,49,554000,548000,-6000
280744,16,52,548000,532000,-16000
280744,17,NA,532000,532000,0
280744,18,36,532000,499000,-33000
280744,19,59,499000,478000,-21000
280744,20,80,478000,485000,7000
280744,21,84,485000,510000,25000
280744,22,52,510000,521000,11000
280744,23,57,521000,526000,5000
280744,24,55,526000,520000,-6000
280804,1,NA,369000,369000,0
280804,2,NA,369000,369000,0
280804,3,NA,369000,369000,0
280804,4,NA,369000,369000,0
280804,5,NA,369000,369000,0
280804,6,NA,369000,369000,0
280804,7,NA,369000,369000,0
280804,8,NA,369000,369000,0
280804,9,NA,369000,369000,0
280804,10,NA,369000,369000,0
280804,11,NA,369000,369000,0
280804,12,NA,369000,369000,0
280804,13,NA,369000,369000,0
280804,14,NA,369000,369000,0
280804,15,NA,369000,369000,0
280804,16,NA,369000,369000,0
280804,17,NA,369000,369000,0
280804,18,NA,369000,369000,0
280804,19,NA,369000,369000,0
280804,20,NA,369000,369000,0
280804,21,NA,369000,369000,0
280804,22,NA,369000,369000,0
280804,23,NA,369000,369000,0
280804,24,NA,369000,369000,0
280819,1,55,387000,395000,8000
280819,2,21,395000,382000,-13000
280819,3,46,382000,375000,-7000
280819,4,44,375000,370000,-5000
280819,5,44,370000,368000,-2000
280819,6,31,368000,359000,-9000
280819,7,33,359000,348000,-11000
280819,8,31,348000,334000,-14000
280819,9,29,334000,317000,-17000
280819,10,67,317000,328000,11000
280819,11,60,328000,352000,24000
280819,12,37,352000,365000,13000
280819,13,31,365000,364000,-1000
280819,14,24,364000,351000,-13000
280819,15,NA,351000,351000,0
280819,16,27,351000,328000,-23000
280819,17,31,328000,308000,-20000
280819,18,31,308000,292000,-16000
280819,19,34,292000,285000,-7000
280819,20,18,285000,271000,-14000
280819,21,NA,271000,271000,0
280819,22,29,271000,261000,-10000
280819,23,71,261000,283000,22000
280819,24,23,283000,289000,6000
280824,1,16,445000,419000,-26000
280824,2,21,419000,380000,-39000
280824,3,25,380000,340000,-40000
280824,4,NA,340000,340000,0
280824,5,42,340000,319000,-21000
280824,6,NA,319000,319000,0
280824,7,NA,319000,319000,0
280824,8,NA,319000,319000,0
280824,9,NA,319000,319000,0
280824,10,NA,319000,319000,0
280824,11,NA,319000,319000,0
280824,12,NA,319000,319000,0
280824,13,NA,319000,319000,0
280824,14,NA,319000,319000,0
280824,15,NA,319000,319000,0
280824,16,44,319000,313000,-6000
280824,17,62,313000,331000,18000
280824,18,87,331000,379000,48000
280824,19,46,379000,410000,31000
280824,20,65,410000,439000,29000
280824,21,50,439000,454000,15000
280824,22,28,454000,440000,-14000
280824,23,99,440000,461000,21000
280824,24,49,461000,469000,8000
280921,1,61,668000,656000,-12000
280921,2,70,656000,644000,-12000
280921,3,65,644000,628000,-16000
280921,4,28,628000,586000,-42000
280921,5,78,586000,568000,-18000
280921,6,66,568000,559000,-9000
280921,7,97,559000,577000,18000
280921,8,22,577000,558000,-19000
280921,9,NA,558000,558000,0
280921,10,NA,558000,558000,0
280921,11,NA,558000,558000,0
280921,12,NA,558000,558000,0
280921,13,NA,558000,558000,0
280921,14,NA,558000,558000,0
280921,15,NA,558000,558000,0
280921,16,NA,558000,558000,0
280921,17,NA,558000,558000,0
280921,18,NA,558000,558000,0
280921,19,NA,558000,558000,0
280921,20,NA,558000,558000,0
280921,21,NA,558000,558000,0
280921,22,80,558000,557000,-1000
280921,23,NA,557000,557000,0
280921,24,NA,557000,557000,0
280944,1,109,537000,572000,35000
280944,2,109,572000,629000,57000
280944,3,78,629000,670000,41000
280944,4,100,670000,708000,38000
280944,5,87,708000,732000,24000
280944,6,99,732000,751000,19000
280944,7,88,751000,759000,8000
280944,8,168,759000,821000,62000
280944,9,104,821000,863000,42000
280944,10,95,863000,883000,20000
280944,11,88,883000,882000,-1000
280944,12,73,882000,854000,-28000
280944,13,108,854000,835000,-19000
280944,14,59,835000,802000,-33000
280944,15,NA,802000,802000,0
280944,16,86,802000,776000,-26000
280944,17,79,776000,752000,-24000
280944,18,66,752000,723000,-29000
280944,19,24,723000,661000,-62000
280944,20,36,661000,597000,-64000
280944,21,138,597000,605000,8000
280944,22,90,605000,625000,20000
280944,23,88,625000,653000,28000
280944,24,NA,653000,653000,0
280965,1,71,624000,623000,-1000
280965,2,86,623000,633000,10000
280965,3,80,633000,645000,12000
280965,4,57,645000,638000,-7000
280965,5,95,638000,649000,11000
280965,6,126,649000,692000,43000
280965,7,93,692000,726000,34000
280965,8,77,726000,741000,15000
280965,9,92,741000,754000,13000
280965,10,74,754000,746000,-8000
280965,11,22,746000,690000,-56000
280965,12,NA,690000,690000,0
280965,13,NA,690000,690000,0
280965,14,NA,690000,690000,0
280965,15,NA,690000,690000,0
280965,16,NA,690000,690000,0
280965,17,NA,690000,690000,0
280965,18,54,690000,635000,-55000
280965,19,96,635000,617000,-18000
280965,20,82,617000,614000,-3000
280965,21,89,614000,628000,14000
280965,22,NA,628000,628000,0
280965,23,72,628000,640000,12000
280965,24,74,640000,644000,4000
280988,1,NA,477000,477000,0
280988,2,NA,477000,477000,0
280988,3,NA,477000,477000,0
280988,4,NA,477000,477000,0
280988,5,NA,477000,477000,0
280988,6,NA,477000,477000,0
280988,7,NA,477000,477000,0
280988,8,NA,477000,477000,0
280988,9,NA,477000,477000,0
280988,10,NA,477000,477000,0
280988,11,NA,477000,477000,0
280988,12,NA,477000,477000,0
280988,13,NA,477000,477000,0
280988,14,NA,477000,477000,0
280988,15,NA,477000,477000,0
280988,16,NA,477000,477000,0
280988,17,NA,477000,477000,0
280988,18,NA,477000,477000,0
280988,19,NA,477000,477000,0
280988,20,NA,477000,477000,0
280988,21,NA,477000,477000,0
280988,22,NA,477000,477000,0
280988,23,NA,477000,477000,0
280988,24,NA,477000,477000,0
281007,1,NA,565000,565000,0
281007,2,44,565000,549000,-16000
281007,3,63,549000,536000,-13000
281007,4,23,536000,500000,-36000
281007,5,72,500000,487000,-13000
281007,6,66,487000,489000,2000
281007,7,47,489000,484000,-5000
281007,8,64,484000,487000,3000
281007,9,44,487000,482000,-5000
281007,10,58,482000,477000,-5000
281007,11,NA,477000,477000,0
281007,12,NA,477000,477000,0
281007,13,42,477000,462000,-15000
281007,14,20,462000,433000,-29000
281007,15,35,433000,401000,-32000
281007,16,97,401000,418000,17000
281007,17,53,418000,432000,14000
281007,18,20,432000,422000,-10000
281007,19,57,422000,422000,0
281007,20,22,422000,401000,-21000
281007,21,44,401000,381000,-20000
281007,22,66,381000,385000,4000
281007,23,NA,385000,385000,0
281007,24,50,385000,392000,7000
281065,1,NA,820000,820000,0
281065,2,NA,820000,820000,0
281065,3,NA,820000,820000,0
281065,4,127,820000,840000,20000
281065,5,55,840000,825000,-15000
281065,6,44,825000,777000,-48000
281065,7,66,777000,727000,-50000
281065,8,86,727000,696000,-31000
281065,9,109,696000,697000,1000
281065,10,NA,697000,697000,0
281065,11,NA,697000,697000,0
281065,12,NA,697000,697000,0
281065,13,NA,697000,697000,0
281065,14,74,697000,701000,4000
281065,15,120,701000,733000,32000
281065,16,86,733000,754000,21000
281065,17,128,754000,792000,38000
281065,18,85,792000,806000,14000
281065,19,92,806000,812000,6000
281065,20,94,812000,811000,-1000
281065,21,85,811000,802000,-9000
281065,22,94,802000,792000,-10000
281065,23,115,792000,802000,10000
281065,24,NA,802000,802000,0
281078,1,7,321000,299000,-22000
281078,2,58,299000,300000,1000
281078,3,48,300000,311000,11000
281078,4,30,311000,315000,4000
281078,5,66,315000,339000,24000
281078,6,43,339000,358000,19000
281078,7,50,358000,373000,15000
281078,8,49,373000,384000,11000
281078,9,36,384000,384000,0
281078,10,33,384000,373000,-11000
281078,11,69,373000,383000,10000
281078,12,18,383000,369000,-14000
281078,13,37,369000,356000,-13000
281078,14,0,356000,321000,-35000
281078,15,NA,321000,321000,0
281078,16,NA,321000,321000,0
281078,17,NA,321000,321000,0
281078,18,NA,321000,321000,0
281078,19,NA,321000,321000,0
281078,20,NA,321000,321000,0
281078,21,37,321000,297000,-24000
281078,22,61,297000,299000,2000
281078,23,62,299000,323000,24000
281078,24,62,323000,355000,32000
281085,1,NA,639000,639000,0
281085,2,NA,639000,639000,0
281085,3,79,639000,641000,2000
281085,4,77,641000,644000,3000
281085,5,56,644000,633000,-11000
281085,6,65,633000,620000,-13000
281085,7,63,620000,604000,-16000
281085,8,52,604000,580000,-24000
281085,9,66,580000,565000,-15000
281085,10,80,565000,566000,1000
281085,11,59,566000,563000,-3000
281085,12,75,563000,567000,4000
281085,13,76,567000,577000,10000
281085,14,NA,577000,577000,0
281085,15,64,577000,582000,5000
281085,16,92,582000,600000,18000
281085,17,123,600000,648000,48000
281085,18,70,648000,672000,24000
281085,19,49,672000,665000,-7000
281085,20,55,665000,642000,-23000
281085,21,62,642000,613000,-29000
281085,22,55,613000,580000,-33000
281085,23,67,580000,561000,-19000
281085,24,74,561000,556000,-5000
281091,1,74,645000,645000,0
281091,2,47,645000,625000,-20000
281091,3,31,625000,580000,-45000
281091,4,48,580000,538000,-42000
281091,5,25,538000,486000,-52000
281091,6,NA,486000,486000,0
281091,7,NA,486000,486000,0
281091,8,NA,486000,486000,0
281091,9,75,486000,467000,-19000
281091,10,87,467000,483000,16000
281091,11,114,483000,537000,54000
281091,12,49,537000,563000,26000
281091,13,NA,563000,563000,0
281091,14,42,563000,566000,3000
281091,15,NA,566000,566000,0
281091,16,27,566000,533000,-33000
281091,17,85,533000,523000,-10000
281091,18,NA,523000,523000,0
281091,19,NA,523000,523000,0
281091,20,NA,523000,523000,0
281091,21,NA,523000,523000,0
281091,22,NA,523000,523000,0
281091,23,67,523000,516000,-7000
281091,24,59,516000,513000,-3000
281124,1,20,390000,372000,-18000
281124,2,41,372000,357000,-15000
281124,3,72,357000,370000,13000
281124,4,66,370000,396000,26000
281124,5,NA,396000,396000,0
281124,6,39,396000,409000,13000
281124,7,NA,409000,409000,0
281124,8,44,409000,414000,5000
281124,9,NA,414000,414000,0
281124,10,44,414000,412000,-2000
281124,11,51,412000,409000,-3000
281124,12,68,409000,419000,10000
281124,13,NA,419000,419000,0
281124,14,68,419000,443000,24000
281124,15,66,443000,467000,24000
281124,16,38,467000,471000,4000
281124,17,88,471000,493000,22000
281124,18,40,493000,492000,-1000
281124,19,61,492000,491000,-1000
281124,20,62,491000,493000,2000
281124,21,74,493000,506000,13000
281124,22,79,506000,526000,20000
281124,23,28,526000,515000,-11000
281124,24,59,515000,504000,-11000
290085,1,43,501000,490000,-11000
290085,2,69,490000,491000,1000
290085,3,NA,491000,491000,0
290085,4,NA,491000,491000,0
290085,5,34,491000,475000,-16000
290085,6,55,475000,465000,-10000
290085,7,44,465000,452000,-13000
290085,8,47,452000,440000,-12000
290085,9,53,440000,434000,-6000
290085,10,58,434000,436000,2000
290085,11,47,436000,435000,-1000
290085,12,57,435000,438000,3000
290085,13,51,438000,440000,2000
290085,14,44,440000,437000,-3000
290085,15,NA,437000,437000,0
290085,16,40,437000,426000,-11000
290085,17,61,426000,426000,0
290085,18,43,426000,421000,-5000
290085,19,43,421000,413000,-8000
290085,20,65,413000,421000,8000
290085,21,52,421000,427000,6000
290085,22,61,427000,438000,11000
290085,23,43,438000,439000,1000
290085,24,NA,439000,439000,0
290160,1,NA,512000,512000,0
290160,2,NA,512000,512000,0
290160,3,42,512000,498000,-14000
290160,4,25,498000,464000,-34000
290160,5,NA,464000,464000,0
290160,6,78,464000,459000,-5000
290160,7,49,459000,454000,-5000
290160,8,NA,454000,454000,0
290160,9,74,454000,467000,13000
290160,10,32,467000,461000,-6000
290160,11,36,461000,445000,-16000
290160,12,NA,445000,445000,0
290160,13,23,445000,411000,-34000
290160,14,NA,411000,411000,0
290160,15,57,411000,397000,-14000
290160,16,NA,397000,397000,0
290160,17,NA,397000,397000,0
290160,18,NA,397000,397000,0
290160,19,NA,397000,397000,0
290160,20,NA,397000,397000,0
290160,21,20,397000,368000,-29000
290160,22,8,368000,328000,-40000
290160,23,NA,328000,328000,0
290160,24,NA,328000,328000,0
290188,1,NA,653000,653000,0
290188,2,NA,653000,653000,0
290188,3,NA,653000,653000,0
290188,4,NA,653000,653000,0
290188,5,NA,653000,653000,0
290188,6,NA,653000,653000,0
290188,7,NA,653000,653000,0
290188,8,NA,653000,653000,0
290188,9,NA,653000,653000,0
290188,10,NA,653000,653000,0
290188,11,NA,653000,653000,0
290188,12,NA,653000,653000,0
290188,13,NA,653000,653000,0
290188,14,NA,653000,653000,0
290188,15,NA,653000,653000,0
290188,16,NA,653000,653000,0
290188,17,NA,653000,653000,0
290188,18,NA,653000,653000,0
290188,19,NA,653000,653000,0
290188,20,NA,653000,653000,0
290188,21,NA,653000,653000,0
290188,22,NA,653000,653000,0
290188,23,NA,653000,653000,0
290188,24,NA,653000,653000,0
290246,1,NA,448000,448000,0
290246,2,NA,448000,448000,0
290246,3,NA,448000,448000,0
290246,4,NA,448000,448000,0
290246,5,NA,448000,448000,0
290246,6,NA,448000,448000,0
290246,7,NA,448000,448000,0
290246,8,NA,448000,448000,0
290246,9,NA,448000,448000,0
290246,10,NA,448000,448000,0
290246,11,NA,448000,448000,0
290246,12,NA,448000,448000,0
290246,13,NA,448000,448000,0
290246,14,NA,448000,448000,0
290246,15,NA,448000,448000,0
290246,16,NA,448000,448000,0
290246,17,NA,448000,448000,0
290246,18,NA,448000,448000,0
290246,19,NA,448000,448000,0
290246,20,NA,448000,448000,0
290246,21,NA,448000,448000,0
290246,22,NA,448000,448000,0
290246,23,NA,448000,448000,0
290246,24,NA,448000,448000,0
290307,1,100,474000,507000,33000
290307,2,61,507000,534000,27000
290307,3,55,534000,545000,11000
290307,4,69,545000,554000,9000
290307,5,NA,554000,554000,0
290307,6,NA,554000,554000,0
290307,7,NA,554000,554000,0
290307,8,NA,554000,554000,0
290307,9,NA,554000,554000,0
290307,10,NA,554000,554000,0
290307,11,NA,554000,554000,0
290307,12,NA,554000,554000,0
290307,13,67,554000,555000,1000
290307,14,58,555000,551000,-4000
290307,15,49,551000,537000,-14000
290307,16,74,537000,537000,0
290307,17,57,537000,531000,-6000
290307,18,65,531000,529000,-2000
290307,19,35,529000,510000,-19000
290307,20,42,510000,485000,-25000
290307,21,NA,485000,485000,0
290307,22,NA,485000,485000,0
290307,23,49,485000,463000,-22000
290307,24,53,463000,446000,-17000
290314,1,NA,350000,350000,0
290314,2,NA,350000,350000,0
290314,3,NA,350000,350000,0
290314,4,NA,350000,350000,0
290314,5,NA,350000,350000,0
290314,6,NA,350000,350000,0
290314,7,NA,350000,350000,0
290314,8,NA,350000,350000,0
290314,9,NA,350000,350000,0
290314,10,NA,350000,350000,0
290314,11,40,350000,348000,-2000
290314,12,30,348000,339000,-9000
290314,13,42,339000,334000,-5000
290314,14,58,334000,346000,12000
290314,15,NA,346000,346000,0
290314,16,17,346000,337000,-9000
290314,17,8,337000,308000,-29000
290314,18,NA,308000,308000,0
290314,19,NA,308000,308000,0
290314,20,43,308000,295000,-13000
290314,21,21,295000,277000,-18000
290314,22,11,277000,250000,-27000
290314,23,32,250000,238000,-12000
290314,24,53,238000,249000,11000
290527,1,46,575000,560000,-15000
290527,2,NA,560000,560000,0
290527,3,NA,560000,560000,0
290527,4,43,560000,532000,-28000
290527,5,55,532000,509000,-23000
290527,6,71,509000,504000,-5000
290527,7,57,504000,501000,-3000
290527,8,29,501000,481000,-20000
290527,9,58,481000,471000,-10000
290527,10,34,471000,448000,-23000
290527,11,46,448000,428000,-20000
290527,12,42,428000,411000,-17000
290527,13,49,411000,403000,-8000
290527,14,47,403000,400000,-3000
290527,15,NA,400000,400000,0
290527,16,44,400000,398000,-2000
290527,17,10,398000,370000,-28000
290527,18,NA,370000,370000,0
290527,19,46,370000,354000,-16000
290527,20,32,354000,337000,-17000
290527,21,14,337000,309000,-28000
290527,22,NA,309000,309000,0
290527,23,NA,309000,309000,0
290527,24,NA,309000,309000,0
290528,1,113,914000,920000,6000
290528,2,4,920000,849000,-71000
290528,3,NA,849000,849000,0
290528,4,NA,849000,849000,0
290528,5,NA,849000,849000,0
290528,6,96,849000,798000,-51000
290528,7,86,798000,761000,-37000
290528,8,107,761000,754000,-7000
290528,9,89,754000,754000,0
290528,10,66,754000,745000,-9000
290528,11,91,745000,740000,-5000
290528,12,87,740000,735000,-5000
290528,13,84,735000,728000,-7000
290528,14,NA,728000,728000,0
290528,15,84,728000,726000,-2000
290528,16,85,726000,726000,0
290528,17,87,726000,725000,-1000
290528,18,162,725000,779000,54000
290528,19,115,779000,829000,50000
290528,20,131,829000,883000,54000
290528,21,97,883000,911000,28000
290528,22,84,911000,906000,-5000
290528,23,100,906000,890000,-16000
290528,24,74,890000,853000,-37000
290550,1,54,849000,817000,-32000
290550,2,98,817000,796000,-21000
290550,3,96,796000,786000,-10000
290550,4,111,786000,794000,8000
290550,5,81,794000,795000,1000
290550,6,81,795000,790000,-5000
290550,7,NA,790000,790000,0
290550,8,NA,790000,790000,0
290550,9,NA,790000,790000,0
290550,10,NA,790000,790000,0
290550,11,NA,790000,790000,0
290550,12,NA,790000,790000,0
290550,13,NA,790000,790000,0
290550,14,NA,790000,790000,0
290550,15,NA,790000,790000,0
290550,16,NA,790000,790000,0
290550,17,NA,790000,790000,0
290550,18,NA,790000,790000,0
290550,19,NA,790000,790000,0
290550,20,NA,790000,790000,0
290550,21,NA,790000,790000,0
290550,22,NA,790000,790000,0
290550,23,NA,790000,790000,0
290550,24,NA,790000,790000,0
290627,1,71,788000,773000,-15000
290627,2,46,773000,731000,-42000
290627,3,94,731000,709000,-22000
290627,4,68,709000,686000,-23000
290627,5,75,686000,671000,-15000
290627,6,68,671000,658000,-13000
290627,7,NA,658000,658000,0
290627,8,86,658000,658000,0
290627,9,80,658000,659000,1000
290627,10,30,659000,626000,-33000
290627,11,78,626000,609000,-17000
290627,12,87,609000,609000,0
290627,13,78,609000,613000,4000
290627,14,85,613000,629000,16000
290627,15,NA,629000,629000,0
290627,16,NA,629000,629000,0
290627,17,90,629000,652000,23000
290627,18,72,652000,661000,9000
290627,19,111,661000,687000,26000
290627,20,83,687000,704000,17000
290627,21,72,704000,705000,1000
290627,22,67,705000,692000,-13000
290627,23,76,692000,679000,-13000
290627,24,NA,679000,679000,0
290629,1,62,739000,722000,-17000
290629,2,60,722000,692000,-30000
290629,3,64,692000,661000,-31000
290629,4,64,661000,632000,-29000
290629,5,79,632000,621000,-11000
290629,6,65,621000,612000,-9000
290629,7,NA,612000,612000,0
290629,8,70,612000,607000,-5000
290629,9,95,607000,622000,15000
290629,10,92,622000,644000,22000
290629,11,93,644000,670000,26000
290629,12,87,670000,691000,21000
290629,13,86,691000,706000,15000
290629,14,NA,706000,706000,0
290629,15,80,706000,711000,5000
290629,16,85,711000,714000,3000
290629,17,114,714000,735000,21000
290629,18,87,735000,747000,12000
290629,19,92,747000,757000,10000
290629,20,97,757000,769000,12000
290629,21,103,769000,783000,14000
290629,22,71,783000,773000,-10000
290629,23,56,773000,742000,-31000
290629,24,93,742000,722000,-20000
290675,1,44,432000,428000,-4000
290675,2,41,428000,419000,-9000
290675,3,60,419000,421000,2000
290675,4,58,421000,429000,8000
290675,5,45,429000,431000,2000
290675,6,NA,431000,431000,0
290675,7,NA,431000,431000,0
290675,8,52,431000,434000,3000
290675,9,55,434000,438000,4000
290675,10,NA,438000,438000,0
290675,11,50,438000,437000,-1000
290675,12,74,437000,452000,15000
290675,13,74,452000,477000,25000
290675,14,66,477000,501000,24000
290675,15,NA,501000,501000,0
290675,16,33,501000,497000,-4000
290675,17,52,497000,487000,-10000
290675,18,69,487000,486000,-1000
290675,19,68,486000,492000,6000
290675,20,47,492000,488000,-4000
290675,21,48,488000,482000,-6000
290675,22,48,482000,470000,-12000
290675,23,64,470000,467000,-3000
290675,24,76,467000,478000,11000
290746,1,60,622000,613000,-9000
290746,2,46,613000,589000,-24000
290746,3,68,589000,572000,-17000
290746,4,69,572000,564000,-8000
290746,5,23,564000,530000,-34000
290746,6,NA,530000,530000,0
290746,7,NA,530000,530000,0
290746,8,NA,530000,530000,0
290746,9,NA,530000,530000,0
290746,10,83,530000,523000,-7000
290746,11,100,523000,549000,26000
290746,12,53,549000,556000,7000
290746,13,86,556000,576000,20000
290746,14,69,576000,594000,18000
290746,15,NA,594000,594000,0
290746,16,NA,594000,594000,0
290746,17,NA,594000,594000,0
290746,18,64,594000,595000,1000
290746,19,37,595000,569000,-26000
290746,20,NA,569000,569000,0
290746,21,NA,569000,569000,0
290746,22,NA,569000,569000,0
290746,23,NA,569000,569000,0
290746,24,NA,569000,569000,0
290757,1,54,509000,506000,-3000
290757,2,NA,506000,506000,0
290757,3,54,506000,499000,-7000
290757,4,NA,499000,499000,0
290757,5,NA,499000,499000,0
290757,6,NA,499000,499000,0
290757,7,NA,499000,499000,0
290757,8,NA,499000,499000,0
290757,9,NA,499000,499000,0
290757,10,63,499000,497000,-2000
290757,11,61,497000,497000,0
290757,12,NA,497000,497000,0
290757,13,67,497000,503000,6000
290757,14,64,503000,514000,11000
290757,15,62,514000,521000,7000
290757,16,67,521000,528000,7000
290757,17,85,528000,548000,20000
290757,18,48,548000,547000,-1000
290757,19,72,547000,552000,5000
290757,20,49,552000,542000,-10000
290757,21,82,542000,548000,6000
290757,22,40,548000,532000,-16000
290757,23,71,532000,530000,-2000
290757,24,71,530000,531000,1000
290778,1,83,871000,858000,-13000
290778,2,103,858000,852000,-6000
290778,3,69,852000,826000,-26000
290778,4,87,826000,803000,-23000
290778,5,61,803000,766000,-37000
290778,6,80,766000,739000,-27000
290778,7,112,739000,741000,2000
290778,8,117,741000,767000,26000
290778,9,88,767000,783000,16000
290778,10,113,783000,809000,26000
290778,11,75,809000,810000,1000
290778,12,NA,810000,810000,0
290778,13,NA,810000,810000,0
290778,14,126,810000,831000,21000
290778,15,93,831000,838000,7000
290778,16,107,838000,848000,10000
290778,17,84,848000,841000,-7000
290778,18,83,841000,826000,-15000
290778,19,127,826000,834000,8000
290778,20,52,834000,807000,-27000
290778,21,88,807000,785000,-22000
290778,22,75,785000,760000,-25000
290778,23,57,760000,721000,-39000
290778,24,97,721000,701000,-20000
290797,1,42,449000,442000,-7000
290797,2,85,442000,462000,20000
290797,3,72,462000,489000,27000
290797,4,13,489000,473000,-16000
290797,5,NA,473000,473000,0
290797,6,39,473000,452000,-21000
290797,7,54,452000,438000,-14000
290797,8,41,438000,419000,-19000
290797,9,42,419000,403000,-16000
290797,10,NA,403000,403000,0
290797,11,NA,403000,403000,0
290797,12,NA,403000,403000,0
290797,13,55,403000,402000,-1000
290797,14,61,402000,414000,12000
290797,15,NA,414000,414000,0
290797,16,49,414000,422000,8000
290797,17,49,422000,426000,4000
290797,18,46,426000,425000,-1000
290797,19,48,425000,421000,-4000
290797,20,19,421000,396000,-25000
290797,21,NA,396000,396000,0
290797,22,58,396000,388000,-8000
290797,23,99,388000,421000,33000
290797,24,54,421000,444000,23000
290799,1,114,801000,817000,16000
290799,2,98,817000,832000,15000
290799,3,119,832000,857000,25000
290799,4,114,857000,882000,25000
290799,5,80,882000,880000,-2000
290799,6,97,880000,873000,-7000
290799,7,NA,873000,873000,0
290799,8,100,873000,865000,-8000
290799,9,118,865000,869000,4000
290799,10,108,869000,876000,7000
290799,11,76,876000,863000,-13000
290799,12,121,863000,867000,4000
290799,13,109,867000,874000,7000
290799,14,106,874000,883000,9000
290799,15,NA,883000,883000,0
290799,16,97,883000,884000,1000
290799,17,84,884000,869000,-15000
290799,18,118,869000,868000,-1000
290799,19,120,868000,880000,12000
290799,20,109,880000,891000,11000
290799,21,133,891000,919000,28000
290799,22,22,919000,875000,-44000
290799,23,NA,875000,875000,0
290799,24,127,875000,857000,-18000
290801,1,89,719000,724000,5000
290801,2,78,724000,723000,-1000
290801,3,94,723000,730000,7000
290801,4,99,730000,743000,13000
290801,5,56,743000,730000,-13000
290801,6,104,730000,735000,5000
290801,7,49,735000,711000,-24000
290801,8,49,711000,670000,-41000
290801,9,69,670000,637000,-33000
290801,10,42,637000,595000,-42000
290801,11,45,595000,551000,-44000
290801,12,80,551000,539000,-12000
290801,13,46,539000,521000,-18000
290801,14,NA,521000,521000,0
290801,15,46,521000,503000,-18000
290801,16,83,503000,511000,8000
290801,17,30,511000,495000,-16000
290801,18,88,495000,504000,9000
290801,19,109,504000,547000,43000
290801,20,87,547000,590000,43000
290801,21,77,590000,621000,31000
290801,22,76,621000,642000,21000
290801,23,99,642000,665000,23000
290801,24,54,665000,655000,-10000
290826,1,67,647000,641000,-6000
290826,2,73,641000,637000,-4000
290826,3,25,637000,598000,-39000
290826,4,NA,598000,598000,0
290826,5,NA,598000,598000,0
290826,6,NA,598000,598000,0
290826,7,NA,598000,598000,0
290826,8,NA,598000,598000,0
290826,9,NA,598000,598000,0
290826,10,NA,598000,598000,0
290826,11,NA,598000,598000,0
290826,12,NA,598000,598000,0
290826,13,NA,598000,598000,0
290826,14,NA,598000,598000,0
290826,15,NA,598000,598000,0
290826,16,100,598000,594000,-4000
290826,17,28,594000,562000,-32000
290826,18,75,562000,550000,-12000
290826,19,62,550000,541000,-9000
290826,20,110,541000,572000,31000
290826,21,81,572000,599000,27000
290826,22,49,599000,603000,4000
290826,23,116,603000,635000,32000
290826,24,47,635000,630000,-5000
290832,1,74,717000,711000,-6000
290832,2,70,711000,697000,-14000
290832,3,78,697000,686000,-11000
290832,4,68,686000,670000,-16000
290832,5,125,670000,696000,26000
290832,6,62,696000,700000,4000
290832,7,84,700000,704000,4000
290832,8,81,704000,705000,1000
290832,9,94,705000,713000,8000
290832,10,64,713000,699000,-14000
290832,11,89,699000,698000,-1000
290832,12,72,698000,688000,-10000
290832,13,NA,688000,688000,0
290832,14,72,688000,680000,-8000
290832,15,40,680000,644000,-36000
290832,16,51,644000,606000,-38000
290832,17,46,606000,563000,-43000
290832,18,64,563000,536000,-27000
290832,19,54,536000,515000,-21000
290832,20,102,515000,536000,21000
290832,21,46,536000,539000,3000
290832,22,84,539000,556000,17000
290832,23,108,556000,595000,39000
290832,24,37,595000,593000,-2000
290838,1,71,552000,557000,5000
290838,2,75,557000,569000,12000
290838,3,63,569000,575000,6000
290838,4,37,575000,555000,-20000
290838,5,55,555000,536000,-19000
290838,6,60,536000,521000,-15000
290838,7,50,521000,504000,-17000
290838,8,33,504000,476000,-28000
290838,9,37,476000,448000,-28000
290838,10,NA,448000,448000,0
290838,11,NA,448000,448000,0
290838,12,NA,448000,448000,0
290838,13,50,448000,428000,-20000
290838,14,NA,428000,428000,0
290838,15,50,428000,417000,-11000
290838,16,41,417000,407000,-10000
290838,17,35,407000,393000,-14000
290838,18,86,393000,414000,21000
290838,19,62,414000,436000,22000
290838,20,94,436000,480000,44000
290838,21,66,480000,515000,35000
290838,22,27,515000,511000,-4000
290838,23,82,511000,518000,7000
290838,24,93,518000,541000,23000
290847,1,76,677000,676000,-1000
290847,2,64,676000,664000,-12000
290847,3,NA,664000,664000,0
290847,4,81,664000,658000,-6000
290847,5,67,658000,648000,-10000
290847,6,94,648000,656000,8000
290847,7,71,656000,657000,1000
290847,8,106,657000,680000,23000
290847,9,114,680000,718000,38000
290847,10,100,718000,752000,34000
290847,11,60,752000,750000,-2000
290847,12,63,750000,729000,-21000
290847,13,87,729000,713000,-16000
290847,14,114,713000,725000,12000
290847,15,NA,725000,725000,0
290847,16,NA,725000,725000,0
290847,17,91,725000,735000,10000
290847,18,94,735000,751000,16000
290847,19,97,751000,767000,16000
290847,20,90,767000,774000,7000
290847,21,NA,774000,774000,0
290847,22,90,774000,774000,0
290847,23,127,774000,798000,24000
290847,24,113,798000,822000,24000
291313,1,31,584000,557000,-27000
291313,2,NA,557000,557000,0
291313,3,NA,557000,557000,0
291313,4,NA,557000,557000,0
291313,5,NA,557000,557000,0
291313,6,NA,557000,557000,0
291313,7,NA,557000,557000,0
291313,8,NA,557000,557000,0
291313,9,NA,557000,557000,0
291313,10,NA,557000,557000,0
291313,11,NA,557000,557000,0
291313,12,NA,557000,557000,0
291313,13,NA,557000,557000,0
291313,14,NA,557000,557000,0
291313,15,82,557000,549000,-8000
291313,16,33,549000,523000,-26000
291313,17,89,523000,526000,3000
291313,18,73,526000,537000,11000
291313,19,39,537000,530000,-7000
291313,20,98,530000,549000,19000
291313,21,52,549000,553000,4000
291313,22,62,553000,550000,-3000
291313,23,50,550000,537000,-13000
291313,24,83,537000,541000,4000
291327,1,NA,514000,514000,0
291327,2,NA,514000,514000,0
291327,3,59,514000,512000,-2000
291327,4,NA,512000,512000,0
291327,5,NA,512000,512000,0
291327,6,NA,512000,512000,0
291327,7,NA,512000,512000,0
291327,8,74,512000,521000,9000
291327,9,80,521000,541000,20000
291327,10,70,541000,557000,16000
291327,11,73,557000,572000,15000
291327,12,60,572000,574000,2000
291327,13,NA,574000,574000,0
291327,14,NA,574000,574000,0
291327,15,NA,574000,574000,0
291327,16,NA,574000,574000,0
291327,17,NA,574000,574000,0
291327,18,NA,574000,574000,0
291327,19,NA,574000,574000,0
291327,20,NA,574000,574000,0
291327,21,NA,574000,574000,0
291327,22,NA,574000,574000,0
291327,23,NA,574000,574000,0
291327,24,NA,574000,574000,0
291351,1,49,535000,526000,-9000
291351,2,65,526000,522000,-4000
291351,3,71,522000,528000,6000
291351,4,30,528000,508000,-20000
291351,5,NA,508000,508000,0
291351,6,56,508000,495000,-13000
291351,7,35,495000,470000,-25000
291351,8,67,470000,463000,-7000
291351,9,34,463000,444000,-19000
291351,10,100,444000,469000,25000
291351,11,28,469000,466000,-3000
291351,12,NA,466000,466000,0
291351,13,40,466000,454000,-12000
291351,14,NA,454000,454000,0
291351,15,NA,454000,454000,0
291351,16,NA,454000,454000,0
291351,17,127,454000,498000,44000
291351,18,81,498000,541000,43000
291351,19,47,541000,553000,12000
291351,20,27,553000,536000,-17000
291351,21,60,536000,520000,-16000
291351,22,15,520000,470000,-50000
291351,23,NA,470000,470000,0
291351,24,NA,470000,470000,0
291357,1,46,490000,482000,-8000
291357,2,46,482000,470000,-12000
291357,3,42,470000,452000,-18000
291357,4,46,452000,436000,-16000
291357,5,NA,436000,436000,0
291357,6,71,436000,443000,7000
291357,7,31,443000,433000,-10000
291357,8,NA,433000,433000,0
291357,9,NA,433000,433000,0
291357,10,NA,433000,433000,0
291357,11,NA,433000,433000,0
291357,12,56,433000,430000,-3000
291357,13,NA,430000,430000,0
291357,14,65,430000,441000,11000
291357,15,102,441000,483000,42000
291357,16,37,483000,495000,12000
291357,17,51,495000,497000,2000
291357,18,35,497000,480000,-17000
291357,19,NA,480000,480000,0
291357,20,42,480000,455000,-25000
291357,21,70,455000,449000,-6000
291357,22,13,449000,419000,-30000
291357,23,NA,419000,419000,0
291357,24,NA,419000,419000,0
291492,1,52,473000,471000,-2000
291492,2,84,471000,492000,21000
291492,3,34,492000,489000,-3000
291492,4,54,489000,484000,-5000
291492,5,31,484000,462000,-22000
291492,6,NA,462000,462000,0
291492,7,NA,462000,462000,0
291492,8,NA,462000,462000,0
291492,9,NA,462000,462000,0
291492,10,NA,462000,462000,0
291492,11,NA,462000,462000,0
291492,12,NA,462000,462000,0
291492,13,37,462000,433000,-29000
291492,14,NA,433000,433000,0
291492,15,NA,433000,433000,0
291492,16,NA,433000,433000,0
291492,17,NA,433000,433000,0
291492,18,NA,433000,433000,0
291492,19,19,433000,392000,-41000
291492,20,21,392000,351000,-41000
291492,21,NA,351000,351000,0
291492,22,NA,351000,351000,0
291492,23,NA,351000,351000,0
291492,24,NA,351000,351000,0
291509,1,52,559000,550000,-9000
291509,2,34,550000,522000,-28000
291509,3,NA,522000,522000,0
291509,4,19,522000,471000,-51000
291509,5,14,471000,411000,-60000
291509,6,11,411000,349000,-62000
291509,7,NA,349000,349000,0
291509,8,NA,349000,349000,0
291509,9,NA,349000,349000,0
291509,10,NA,349000,349000,0
291509,11,NA,349000,349000,0
291509,12,NA,349000,349000,0
291509,13,NA,349000,349000,0
291509,14,NA,349000,349000,0
291509,15,NA,349000,349000,0
291509,16,NA,349000,349000,0
291509,17,NA,349000,349000,0
291509,18,NA,349000,349000,0
291509,19,NA,349000,349000,0
291509,20,NA,349000,349000,0
291509,21,NA,349000,349000,0
291509,22,NA,349000,349000,0
291509,23,NA,349000,349000,0
291509,24,NA,349000,349000,0
291533,1,62,640000,631000,-9000
291533,2,47,631000,606000,-25000
291533,3,NA,606000,606000,0
291533,4,99,606000,609000,3000
291533,5,28,609000,581000,-28000
291533,6,NA,581000,581000,0
291533,7,NA,581000,581000,0
291533,8,NA,581000,581000,0
291533,9,NA,581000,581000,0
291533,10,40,581000,543000,-38000
291533,11,39,543000,503000,-40000
291533,12,NA,503000,503000,0
291533,13,NA,503000,503000,0
291533,14,NA,503000,503000,0
291533,15,NA,503000,503000,0
291533,16,NA,503000,503000,0
291533,17,NA,503000,503000,0
291533,18,NA,503000,503000,0
291533,19,NA,503000,503000,0
291533,20,NA,503000,503000,0
291533,21,NA,503000,503000,0
291533,22,NA,503000,503000,0
291533,23,NA,503000,503000,0
291533,24,NA,503000,503000,0
291548,1,NA,357000,357000,0
291548,2,NA,357000,357000,0
291548,3,NA,357000,357000,0
291548,4,NA,357000,357000,0
291548,5,NA,357000,357000,0
291548,6,NA,357000,357000,0
291548,7,58,357000,368000,11000
291548,8,53,368000,383000,15000
291548,9,77,383000,416000,33000
291548,10,64,416000,446000,30000
291548,11,51,446000,463000,17000
291548,12,NA,463000,463000,0
291548,13,NA,463000,463000,0
291548,14,49,463000,469000,6000
291548,15,83,469000,489000,20000
291548,16,52,489000,496000,7000
291548,17,41,496000,486000,-10000
291548,18,57,486000,480000,-6000
291548,19,52,480000,472000,-8000
291548,20,105,472000,500000,28000
291548,21,80,500000,534000,34000
291548,22,82,534000,570000,36000
291548,23,56,570000,583000,13000
291548,24,50,583000,573000,-10000
291570,1,46,681000,657000,-24000
291570,2,NA,657000,657000,0
291570,3,NA,657000,657000,0
291570,4,NA,657000,657000,0
291570,5,NA,657000,657000,0
291570,6,NA,657000,657000,0
291570,7,NA,657000,657000,0
291570,8,38,657000,610000,-47000
291570,9,17,610000,541000,-69000
291570,10,39,541000,480000,-61000
291570,11,55,480000,445000,-35000
291570,12,NA,445000,445000,0
291570,13,83,445000,449000,4000
291570,14,47,449000,456000,7000
291570,15,73,456000,477000,21000
291570,16,46,477000,483000,6000
291570,17,NA,483000,483000,0
291570,18,NA,483000,483000,0
291570,19,NA,483000,483000,0
291570,20,NA,483000,483000,0
291570,21,NA,483000,483000,0
291570,22,NA,483000,483000,0
291570,23,NA,483000,483000,0
291570,24,NA,483000,483000,0
291720,1,72,513000,522000,9000
291720,2,68,522000,535000,13000
291720,3,24,535000,515000,-20000
291720,4,77,515000,514000,-1000
291720,5,57,514000,510000,-4000
291720,6,39,510000,493000,-17000
291720,7,55,493000,481000,-12000
291720,8,77,481000,491000,10000
291720,9,51,491000,491000,0
291720,10,82,491000,508000,17000
291720,11,56,508000,518000,10000
291720,12,18,518000,492000,-26000
291720,13,66,492000,479000,-13000
291720,14,NA,479000,479000,0
291720,15,58,479000,473000,-6000
291720,16,81,473000,487000,14000
291720,17,22,487000,472000,-15000
291720,18,NA,472000,472000,0
291720,19,NA,472000,472000,0
291720,20,10,472000,433000,-39000
291720,21,NA,433000,433000,0
291720,22,61,433000,413000,-20000
291720,23,43,413000,396000,-17000
291720,24,92,396000,415000,19000
291748,1,66,688000,678000,-10000
291748,2,78,678000,671000,-7000
291748,3,63,671000,655000,-16000
291748,4,87,655000,653000,-2000
291748,5,85,653000,660000,7000
291748,6,79,660000,667000,7000
291748,7,58,667000,657000,-10000
291748,8,93,657000,662000,5000
291748,9,121,662000,695000,33000
291748,10,56,695000,696000,1000
291748,11,NA,696000,696000,0
291748,12,85,696000,698000,2000
291748,13,79,698000,697000,-1000
291748,14,NA,697000,697000,0
291748,15,71,697000,687000,-10000
291748,16,89,687000,685000,-2000
291748,17,94,685000,695000,10000
291748,18,109,695000,719000,24000
291748,19,78,719000,730000,11000
291748,20,78,730000,732000,2000
291748,21,99,732000,739000,7000
291748,22,63,739000,724000,-15000
291748,23,96,724000,720000,-4000
291748,24,64,720000,701000,-19000
291753,1,NA,367000,367000,0
291753,2,NA,367000,367000,0
291753,3,NA,367000,367000,0
291753,4,NA,367000,367000,0
291753,5,NA,367000,367000,0
291753,6,NA,367000,367000,0
291753,7,NA,367000,367000,0
291753,8,NA,367000,367000,0
291753,9,69,367000,385000,18000
291753,10,9,385000,371000,-14000
291753,11,NA,371000,371000,0
291753,12,NA,371000,371000,0
291753,13,NA,371000,371000,0
291753,14,NA,371000,371000,0
291753,15,NA,371000,371000,0
291753,16,NA,371000,371000,0
291753,17,NA,371000,371000,0
291753,18,NA,371000,371000,0
291753,19,NA,371000,371000,0
291753,20,NA,371000,371000,0
291753,21,NA,371000,371000,0
291753,22,27,371000,350000,-21000
291753,23,NA,350000,350000,0
291753,24,NA,350000,350000,0
291776,1,62,722000,706000,-16000
291776,2,88,706000,700000,-6000
291776,3,59,700000,680000,-20000
291776,4,71,680000,661000,-19000
291776,5,59,661000,638000,-23000
291776,6,NA,638000,638000,0
291776,7,72,638000,623000,-15000
291776,8,87,623000,624000,1000
291776,9,86,624000,636000,12000
291776,10,27,636000,610000,-26000
291776,11,70,610000,593000,-17000
291776,12,95,593000,598000,5000
291776,13,104,598000,624000,26000
291776,14,NA,624000,624000,0
291776,15,78,624000,647000,23000
291776,16,75,647000,664000,17000
291776,17,83,664000,675000,11000
291776,18,125,675000,709000,34000
291776,19,102,709000,741000,32000
291776,20,50,741000,735000,-6000
291776,21,50,735000,704000,-31000
291776,22,105,704000,697000,-7000
291776,23,67,697000,678000,-19000
291776,24,68,678000,656000,-22000
291783,1,70,747000,735000,-12000
291783,2,103,735000,740000,5000
291783,3,110,740000,761000,21000
291783,4,98,761000,781000,20000
291783,5,97,781000,799000,18000
291783,6,65,799000,790000,-9000
291783,7,82,790000,773000,-17000
291783,8,64,773000,741000,-32000
291783,9,61,741000,702000,-39000
291783,10,NA,702000,702000,0
291783,11,NA,702000,702000,0
291783,12,44,702000,650000,-52000
291783,13,NA,650000,650000,0
291783,14,NA,650000,650000,0
291783,15,NA,650000,650000,0
291783,16,17,650000,581000,-69000
291783,17,17,581000,502000,-79000
291783,18,NA,502000,502000,0
291783,19,NA,502000,502000,0
291783,20,NA,502000,502000,0
291783,21,NA,502000,502000,0
291783,22,NA,502000,502000,0
291783,23,NA,502000,502000,0
291783,24,NA,502000,502000,0
291790,1,121,854000,871000,17000
291790,2,NA,871000,871000,0
291790,3,99,871000,880000,9000
291790,4,78,880000,868000,-12000
291790,5,105,868000,862000,-6000
291790,6,112,862000,867000,5000
291790,7,92,867000,861000,-6000
291790,8,76,861000,841000,-20000
291790,9,NA,841000,841000,0
291790,10,NA,841000,841000,0
291790,11,NA,841000,841000,0
291790,12,130,841000,849000,8000
291790,13,110,849000,861000,12000
291790,14,113,861000,881000,20000
291790,15,NA,881000,881000,0
291790,16,111,881000,898000,17000
291790,17,75,898000,887000,-11000
291790,18,99,887000,871000,-16000
291790,19,92,871000,852000,-19000
291790,20,134,852000,864000,12000
291790,21,107,864000,876000,12000
291790,22,72,876000,863000,-13000
291790,23,143,863000,883000,20000
291790,24,131,883000,910000,27000
291800,1,14,836000,775000,-61000
291800,2,NA,775000,775000,0
291800,3,126,775000,757000,-18000
291800,4,70,757000,733000,-24000
291800,5,98,733000,730000,-3000
291800,6,100,730000,744000,14000
291800,7,113,744000,776000,32000
291800,8,88,776000,790000,14000
291800,9,96,790000,801000,11000
291800,10,72,801000,788000,-13000
291800,11,121,788000,799000,11000
291800,12,115,799000,817000,18000
291800,13,NA,817000,817000,0
291800,14,66,817000,813000,-4000
291800,15,100,813000,812000,-1000
291800,16,105,812000,819000,7000
291800,17,111,819000,829000,10000
291800,18,79,829000,821000,-8000
291800,19,116,821000,833000,12000
291800,20,112,833000,848000,15000
291800,21,94,848000,852000,4000
291800,22,72,852000,833000,-19000
291800,23,133,833000,845000,12000
291800,24,118,845000,860000,15000
291819,1,82,418000,443000,25000
291819,2,40,443000,453000,10000
291819,3,NA,453000,453000,0
291819,4,NA,453000,453000,0
291819,5,63,453000,466000,13000
291819,6,NA,466000,466000,0
291819,7,NA,466000,466000,0
291819,8,NA,466000,466000,0
291819,9,NA,466000,466000,0
291819,10,NA,466000,466000,0
291819,11,NA,466000,466000,0
291819,12,38,466000,459000,-7000
291819,13,86,459000,475000,16000
291819,14,NA,475000,475000,0
291819,15,NA,475000,475000,0
291819,16,NA,475000,475000,0
291819,17,NA,475000,475000,0
291819,18,NA,475000,475000,0
291819,19,46,475000,476000,1000
291819,20,19,476000,452000,-24000
291819,21,NA,452000,452000,0
291819,22,NA,452000,452000,0
291819,23,62,452000,442000,-10000
291819,24,NA,442000,442000,0
291848,1,NA,680000,680000,0
291848,2,NA,680000,680000,0
291848,3,NA,680000,680000,0
291848,4,46,680000,653000,-27000
291848,5,56,653000,621000,-32000
291848,6,56,621000,588000,-33000
291848,7,NA,588000,588000,0
291848,8,83,588000,579000,-9000
291848,9,71,579000,578000,-1000
291848,10,96,578000,600000,22000
291848,11,79,600000,621000,21000
291848,12,NA,621000,621000,0
291848,13,67,621000,629000,8000
291848,14,25,629000,601000,-28000
291848,15,48,601000,563000,-38000
291848,16,60,563000,533000,-30000
291848,17,43,533000,501000,-32000
291848,18,37,501000,468000,-33000
291848,19,46,468000,446000,-22000
291848,20,69,446000,445000,-1000
291848,21,37,445000,434000,-11000
291848,22,39,434000,421000,-13000
291848,23,38,421000,405000,-16000
291848,24,55,405000,399000,-6000
291849,1,59,492000,494000,2000
291849,2,66,494000,502000,8000
291849,3,75,502000,519000,17000
291849,4,64,519000,532000,13000
291849,5,72,532000,547000,15000
291849,6,24,547000,528000,-19000
291849,7,49,528000,504000,-24000
291849,8,77,504000,500000,-4000
291849,9,47,500000,490000,-10000
291849,10,82,490000,502000,12000
291849,11,71,502000,521000,19000
291849,12,98,521000,558000,37000
291849,13,46,558000,566000,8000
291849,14,NA,566000,566000,0
291849,15,31,566000,546000,-20000
291849,16,53,546000,522000,-24000
291849,17,NA,522000,522000,0
291849,18,NA,522000,522000,0
291849,19,37,522000,487000,-35000
291849,20,29,487000,444000,-43000
291849,21,43,444000,414000,-30000
291849,22,81,414000,422000,8000
291849,23,73,422000,444000,22000
291849,24,89,444000,485000,41000
291856,1,84,853000,842000,-11000
291856,2,98,842000,835000,-7000
291856,3,103,835000,835000,0
291856,4,63,835000,810000,-25000
291856,5,107,810000,805000,-5000
291856,6,97,805000,806000,1000
291856,7,100,806000,809000,3000
291856,8,72,809000,796000,-13000
291856,9,120,796000,808000,12000
291856,10,86,808000,807000,-1000
291856,11,112,807000,818000,11000
291856,12,124,818000,843000,25000
291856,13,121,843000,875000,32000
291856,14,NA,875000,875000,0
291856,15,109,875000,899000,24000
291856,16,101,899000,911000,12000
291856,17,88,911000,900000,-11000
291856,18,60,900000,857000,-43000
291856,19,48,857000,791000,-66000
291856,20,83,791000,743000,-48000
291856,21,41,743000,682000,-61000
291856,22,94,682000,657000,-25000
291856,23,85,657000,652000,-5000
291856,24,115,652000,677000,25000
291861,1,NA,738000,738000,0
291861,2,NA,738000,738000,0
291861,3,NA,738000,738000,0
291861,4,NA,738000,738000,0
291861,5,NA,738000,738000,0
291861,6,NA,738000,738000,0
291861,7,NA,738000,738000,0
291861,8,NA,738000,738000,0
291861,9,NA,738000,738000,0
291861,10,NA,738000,738000,0
291861,11,NA,738000,738000,0
291861,12,NA,738000,738000,0
291861,13,NA,738000,738000,0
291861,14,NA,738000,738000,0
291861,15,NA,738000,738000,0
291861,16,NA,738000,738000,0
291861,17,NA,738000,738000,0
291861,18,NA,738000,738000,0
291861,19,NA,738000,738000,0
291861,20,NA,738000,738000,0
291861,21,NA,738000,738000,0
291861,22,NA,738000,738000,0
291861,23,NA,738000,738000,0
291861,24,NA,738000,738000,0
291867,1,94,442000,474000,32000
291867,2,93,474000,525000,51000
291867,3,11,525000,522000,-3000
291867,4,NA,522000,522000,0
291867,5,NA,522000,522000,0
291867,6,NA,522000,522000,0
291867,7,NA,522000,522000,0
291867,8,NA,522000,522000,0
291867,9,NA,522000,522000,0
291867,10,NA,522000,522000,0
291867,11,NA,522000,522000,0
291867,12,NA,522000,522000,0
291867,13,NA,522000,522000,0
291867,14,NA,522000,522000,0
291867,15,NA,522000,522000,0
291867,16,42,522000,503000,-19000
291867,17,46,503000,477000,-26000
291867,18,38,477000,444000,-33000
291867,19,31,444000,409000,-35000
291867,20,NA,409000,409000,0
291867,21,NA,409000,409000,0
291867,22,NA,409000,409000,0
291867,23,NA,409000,409000,0
291867,24,NA,409000,409000,0
291902,1,NA,854000,854000,0
291902,2,69,854000,831000,-23000
291902,3,63,831000,790000,-41000
291902,4,98,790000,767000,-23000
291902,5,115,767000,774000,7000
291902,6,109,774000,795000,21000
291902,7,83,795000,804000,9000
291902,8,89,804000,807000,3000
291902,9,117,807000,821000,14000
291902,10,63,821000,802000,-19000
291902,11,60,802000,766000,-36000
291902,12,73,766000,731000,-35000
291902,13,135,731000,743000,12000
291902,14,NA,743000,743000,0
291902,15,95,743000,758000,15000
291902,16,148,758000,815000,57000
291902,17,93,815000,849000,34000
291902,18,108,849000,874000,25000
291902,19,91,874000,874000,0
291902,20,133,874000,893000,19000
291902,21,83,893000,885000,-8000
291902,22,142,885000,906000,21000
291902,23,105,906000,918000,12000
291902,24,129,918000,935000,17000
291962,1,56,496000,495000,-1000
291962,2,NA,495000,495000,0
291962,3,NA,495000,495000,0
291962,4,42,495000,482000,-13000
291962,5,11,482000,441000,-41000
291962,6,65,441000,425000,-16000
291962,7,76,425000,435000,10000
291962,8,56,435000,446000,11000
291962,9,31,446000,441000,-5000
291962,10,NA,441000,441000,0
291962,11,NA,441000,441000,0
291962,12,NA,441000,441000,0
291962,13,NA,441000,441000,0
291962,14,NA,441000,441000,0
291962,15,NA,441000,441000,0
291962,16,78,441000,458000,17000
291962,17,60,458000,470000,12000
291962,18,81,470000,493000,23000
291962,19,85,493000,527000,34000
291962,20,116,527000,587000,60000
291962,21,88,587000,634000,47000
291962,22,0,634000,609000,-25000
291962,23,NA,609000,609000,0
291962,24,NA,609000,609000,0
291969,1,104,871000,874000,3000
291969,2,103,874000,877000,3000
291969,3,86,877000,868000,-9000
291969,4,79,868000,845000,-23000
291969,5,115,845000,843000,-2000
291969,6,135,843000,869000,26000
291969,7,101,869000,885000,16000
291969,8,81,885000,880000,-5000
291969,9,98,880000,873000,-7000
291969,10,114,873000,872000,-1000
291969,11,91,872000,861000,-11000
291969,12,101,861000,855000,-6000
291969,13,89,855000,844000,-11000
291969,14,110,844000,849000,5000
291969,15,NA,849000,849000,0
291969,16,105,849000,854000,5000
291969,17,136,854000,882000,28000
291969,18,105,882000,900000,18000
291969,19,91,900000,900000,0
291969,20,129,900000,914000,14000
291969,21,90,914000,909000,-5000
291969,22,63,909000,870000,-39000
291969,23,104,870000,848000,-22000
291969,24,107,848000,835000,-13000
291975,1,137,801000,834000,33000
291975,2,84,834000,849000,15000
291975,3,81,849000,845000,-4000
291975,4,NA,845000,845000,0
291975,5,NA,845000,845000,0
291975,6,83,845000,830000,-15000
291975,7,96,830000,816000,-14000
291975,8,78,816000,792000,-24000
291975,9,99,792000,785000,-7000
291975,10,87,785000,777000,-8000
291975,11,111,777000,788000,11000
291975,12,76,788000,782000,-6000
291975,13,NA,782000,782000,0
291975,14,91,782000,783000,1000
291975,15,83,783000,774000,-9000
291975,16,60,774000,746000,-28000
291975,17,100,746000,736000,-10000
291975,18,108,736000,746000,10000
291975,19,85,746000,750000,4000
291975,20,91,750000,757000,7000
291975,21,108,757000,775000,18000
291975,22,93,775000,784000,9000
291975,23,87,784000,784000,0
291975,24,69,784000,764000,-20000
291978,1,70,591000,592000,1000
291978,2,27,592000,563000,-29000
291978,3,37,563000,522000,-41000
291978,4,28,522000,472000,-50000
291978,5,31,472000,426000,-46000
291978,6,64,426000,410000,-16000
291978,7,35,410000,395000,-15000
291978,8,60,395000,399000,4000
291978,9,58,399000,412000,13000
291978,10,45,412000,418000,6000
291978,11,84,418000,445000,27000
291978,12,NA,445000,445000,0
291978,13,57,445000,464000,19000
291978,14,32,464000,461000,-3000
291978,15,69,461000,468000,7000
291978,16,71,468000,482000,14000
291978,17,48,482000,482000,0
291978,18,95,482000,509000,27000
291978,19,65,509000,531000,22000
291978,20,83,531000,557000,26000
291978,21,51,557000,561000,4000
291978,22,53,561000,553000,-8000
291978,23,30,553000,519000,-34000
291978,24,73,519000,503000,-16000
292128,1,NA,625000,625000,0
292128,2,NA,625000,625000,0
292128,3,NA,625000,625000,0
292128,4,48,625000,605000,-20000
292128,5,44,605000,572000,-33000
292128,6,NA,572000,572000,0
292128,7,NA,572000,572000,0
292128,8,NA,572000,572000,0
292128,9,NA,572000,572000,0
292128,10,NA,572000,572000,0
292128,11,84,572000,561000,-11000
292128,12,94,561000,575000,14000
292128,13,95,575000,605000,30000
292128,14,NA,605000,605000,0
292128,15,98,605000,648000,43000
292128,16,NA,648000,648000,0
292128,17,NA,648000,648000,0
292128,18,NA,648000,648000,0
292128,19,NA,648000,648000,0
292128,20,38,648000,646000,-2000
292128,21,73,646000,638000,-8000
292128,22,62,638000,620000,-18000
292128,23,65,620000,600000,-20000
292128,24,NA,600000,600000,0
292145,1,58,476000,478000,2000
292145,2,11,478000,448000,-30000
292145,3,21,448000,404000,-44000
292145,4,28,404000,362000,-42000
292145,5,NA,362000,362000,0
292145,6,43,362000,339000,-23000
292145,7,NA,339000,339000,0
292145,8,10,339000,305000,-34000
292145,9,58,305000,305000,0
292145,10,32,305000,304000,-1000
292145,11,NA,304000,304000,0
292145,12,NA,304000,304000,0
292145,13,NA,304000,304000,0
292145,14,NA,304000,304000,0
292145,15,NA,304000,304000,0
292145,16,NA,304000,304000,0
292145,17,NA,304000,304000,0
292145,18,30,304000,301000,-3000
292145,19,NA,301000,301000,0
292145,20,NA,301000,301000,0
292145,21,39,301000,301000,0
292145,22,38,301000,304000,3000
292145,23,61,304000,321000,17000
292145,24,31,321000,327000,6000
292511,1,70,734000,723000,-11000
292511,2,56,723000,695000,-28000
292511,3,74,695000,672000,-23000
292511,4,59,672000,643000,-29000
292511,5,57,643000,615000,-28000
292511,6,43,615000,579000,-36000
292511,7,NA,579000,579000,0
292511,8,58,579000,552000,-27000
292511,9,76,552000,543000,-9000
292511,10,58,543000,536000,-7000
292511,11,56,536000,529000,-7000
292511,12,79,529000,537000,8000
292511,13,NA,537000,537000,0
292511,14,76,537000,555000,18000
292511,15,49,555000,552000,-3000
292511,16,97,552000,573000,21000
292511,17,64,573000,583000,10000
292511,18,NA,583000,583000,0
292511,19,59,583000,580000,-3000
292511,20,73,580000,581000,1000
292511,21,47,581000,566000,-15000
292511,22,81,566000,564000,-2000
292511,23,101,564000,588000,24000
292511,24,NA,588000,588000,0
293222,1,57,1066000,1018000,-48000
293222,2,142,1018000,1000000,-18000
293222,3,83,1000000,966000,-34000
293222,4,84,966000,925000,-41000
293222,5,118,925000,911000,-14000
293222,6,120,911000,918000,7000
293222,7,110,918000,921000,3000
293222,8,107,921000,927000,6000
293222,9,101,927000,925000,-2000
293222,10,131,925000,936000,11000
293222,11,131,936000,957000,21000
293222,12,81,957000,947000,-10000
293222,13,124,947000,948000,1000
293222,14,NA,948000,948000,0
293222,15,111,948000,951000,3000
293222,16,85,951000,931000,-20000
293222,17,116,931000,922000,-9000
293222,18,131,922000,933000,11000
293222,19,NA,933000,933000,0
293222,20,115,933000,943000,10000
293222,21,102,943000,944000,1000
293222,22,126,944000,955000,11000
293222,23,118,955000,963000,8000
293222,24,110,963000,959000,-4000
293535,1,72,947000,920000,-27000
293535,2,94,920000,891000,-29000
293535,3,104,891000,873000,-18000
293535,4,76,873000,843000,-30000
293535,5,116,843000,841000,-2000
293535,6,70,841000,824000,-17000
293535,7,119,824000,829000,5000
293535,8,67,829000,811000,-18000
293535,9,103,811000,806000,-5000
293535,10,117,806000,817000,11000
293535,11,100,817000,829000,12000
293535,12,NA,829000,829000,0
293535,13,124,829000,852000,23000
293535,14,100,852000,874000,22000
293535,15,94,874000,876000,2000
293535,16,127,876000,893000,17000
293535,17,127,893000,917000,24000
293535,18,75,917000,906000,-11000
293535,19,105,906000,898000,-8000
293535,20,60,898000,860000,-38000
293535,21,104,860000,835000,-25000
293535,22,80,835000,806000,-29000
293535,23,97,806000,792000,-14000
293535,24,100,792000,787000,-5000
293581,1,50,567000,556000,-11000
293581,2,53,556000,539000,-17000
293581,3,31,539000,505000,-34000
293581,4,42,505000,472000,-33000
293581,5,65,472000,460000,-12000
293581,6,41,460000,446000,-14000
293581,7,52,446000,439000,-7000
293581,8,28,439000,421000,-18000
293581,9,47,421000,408000,-13000
293581,10,67,408000,412000,4000
293581,11,67,412000,429000,17000
293581,12,NA,429000,429000,0
293581,13,56,429000,444000,15000
293581,14,66,444000,467000,23000
293581,15,52,467000,477000,10000
293581,16,61,477000,484000,7000
293581,17,NA,484000,484000,0
293581,18,63,484000,490000,6000
293581,19,77,490000,507000,17000
293581,20,64,507000,520000,13000
293581,21,102,520000,556000,36000
293581,22,44,556000,563000,7000
293581,23,37,563000,544000,-19000
293581,24,NA,544000,544000,0
293651,1,NA,494000,494000,0
293651,2,102,494000,526000,32000
293651,3,33,526000,530000,4000
293651,4,22,530000,501000,-29000
293651,5,NA,501000,501000,0
293651,6,NA,501000,501000,0
293651,7,NA,501000,501000,0
293651,8,NA,501000,501000,0
293651,9,NA,501000,501000,0
293651,10,NA,501000,501000,0
293651,11,NA,501000,501000,0
293651,12,NA,501000,501000,0
293651,13,NA,501000,501000,0
293651,14,NA,501000,501000,0
293651,15,NA,501000,501000,0
293651,16,NA,501000,501000,0
293651,17,NA,501000,501000,0
293651,18,NA,501000,501000,0
293651,19,NA,501000,501000,0
293651,20,NA,501000,501000,0
293651,21,NA,501000,501000,0
293651,22,NA,501000,501000,0
293651,23,NA,501000,501000,0
293651,24,70,501000,486000,-15000
293713,1,NA,761000,761000,0
293713,2,NA,761000,761000,0
293713,3,NA,761000,761000,0
293713,4,NA,761000,761000,0
293713,5,64,761000,741000,-20000
293713,6,83,741000,726000,-15000
293713,7,97,726000,724000,-2000
293713,8,54,724000,702000,-22000
293713,9,48,702000,665000,-37000
293713,10,55,665000,626000,-39000
293713,11,NA,626000,626000,0
293713,12,NA,626000,626000,0
293713,13,NA,626000,626000,0
293713,14,NA,626000,626000,0
293713,15,85,626000,610000,-16000
293713,16,78,610000,606000,-4000
293713,17,60,606000,599000,-7000
293713,18,87,599000,609000,10000
293713,19,62,609000,609000,0
293713,20,94,609000,622000,13000
293713,21,67,622000,626000,4000
293713,22,115,626000,657000,31000
293713,23,50,657000,655000,-2000
293713,24,111,655000,675000,20000
293716,1,NA,810000,810000,0
293716,2,NA,810000,810000,0
293716,3,NA,810000,810000,0
293716,4,NA,810000,810000,0
293716,5,32,810000,763000,-47000
293716,6,31,763000,688000,-75000
293716,7,NA,688000,688000,0
293716,8,13,688000,590000,-98000
293716,9,NA,590000,590000,0
293716,10,NA,590000,590000,0
293716,11,NA,590000,590000,0
293716,12,NA,590000,590000,0
293716,13,NA,590000,590000,0
293716,14,NA,590000,590000,0
293716,15,NA,590000,590000,0
293716,16,NA,590000,590000,0
293716,17,110,590000,559000,-31000
293716,18,76,559000,553000,-6000
293716,19,NA,553000,553000,0
293716,20,NA,553000,553000,0
293716,21,NA,553000,553000,0
293716,22,NA,553000,553000,0
293716,23,39,553000,539000,-14000
293716,24,53,539000,526000,-13000
293738,1,55,455000,457000,2000
293738,2,29,457000,441000,-16000
293738,3,79,441000,450000,9000
293738,4,43,450000,449000,-1000
293738,5,58,449000,454000,5000
293738,6,68,454000,468000,14000
293738,7,67,468000,486000,18000
293738,8,50,486000,490000,4000
293738,9,48,490000,486000,-4000
293738,10,63,486000,485000,-1000
293738,11,47,485000,477000,-8000
293738,12,51,477000,466000,-11000
293738,13,NA,466000,466000,0
293738,14,NA,466000,466000,0
293738,15,38,466000,451000,-15000
293738,16,36,451000,429000,-22000
293738,17,40,429000,407000,-22000
293738,18,26,407000,379000,-28000
293738,19,43,379000,362000,-17000
293738,20,52,362000,359000,-3000
293738,21,NA,359000,359000,0
293738,22,NA,359000,359000,0
293738,23,NA,359000,359000,0
293738,24,NA,359000,359000,0
293801,1,58,642000,630000,-12000
293801,2,55,630000,609000,-21000
293801,3,80,609000,601000,-8000
293801,4,61,601000,590000,-11000
293801,5,59,590000,579000,-11000
293801,6,46,579000,558000,-21000
293801,7,69,558000,548000,-10000
293801,8,85,548000,556000,8000
293801,9,75,556000,569000,13000
293801,10,57,569000,571000,2000
293801,11,53,571000,563000,-8000
293801,12,NA,563000,563000,0
293801,13,NA,563000,563000,0
293801,14,NA,563000,563000,0
293801,15,72,563000,561000,-2000
293801,16,94,561000,578000,17000
293801,17,81,578000,598000,20000
293801,18,62,598000,605000,7000
293801,19,62,605000,603000,-2000
293801,20,53,603000,586000,-17000
293801,21,76,586000,578000,-8000
293801,22,72,578000,575000,-3000
293801,23,83,575000,585000,10000
293801,24,49,585000,576000,-9000
293813,1,63,674000,663000,-11000
293813,2,65,663000,647000,-16000
293813,3,43,647000,613000,-34000
293813,4,36,613000,565000,-48000
293813,5,NA,565000,565000,0
293813,6,NA,565000,565000,0
293813,7,NA,565000,565000,0
293813,8,NA,565000,565000,0
293813,9,NA,565000,565000,0
293813,10,NA,565000,565000,0
293813,11,NA,565000,565000,0
293813,12,NA,565000,565000,0
293813,13,NA,565000,565000,0
293813,14,NA,565000,565000,0
293813,15,NA,565000,565000,0
293813,16,NA,565000,565000,0
293813,17,NA,565000,565000,0
293813,18,NA,565000,565000,0
293813,19,NA,565000,565000,0
293813,20,NA,565000,565000,0
293813,21,NA,565000,565000,0
293813,22,NA,565000,565000,0
293813,23,NA,565000,565000,0
293813,24,NA,565000,565000,0
293845,1,85,737000,737000,0
293845,2,138,737000,776000,39000
293845,3,101,776000,810000,34000
293845,4,137,810000,862000,52000
293845,5,93,862000,887000,25000
293845,6,87,887000,889000,2000
293845,7,82,889000,868000,-21000
293845,8,83,868000,840000,-28000
293845,9,82,840000,807000,-33000
293845,10,64,807000,767000,-40000
293845,11,94,767000,747000,-20000
293845,12,100,747000,745000,-2000
293845,13,NA,745000,745000,0
293845,14,32,745000,710000,-35000
293845,15,-3,710000,627000,-83000
293845,16,NA,627000,627000,0
293845,17,NA,627000,627000,0
293845,18,77,627000,577000,-50000
293845,19,71,577000,548000,-29000
293845,20,84,548000,546000,-2000
293845,21,69,546000,557000,11000
293845,22,112,557000,601000,44000
293845,23,71,601000,626000,25000
293845,24,NA,626000,626000,0
293846,1,NA,799000,799000,0
293846,2,92,799000,798000,-1000
293846,3,117,798000,815000,17000
293846,4,93,815000,825000,10000
293846,5,72,825000,814000,-11000
293846,6,71,814000,789000,-25000
293846,7,79,789000,762000,-27000
293846,8,42,762000,710000,-52000
293846,9,82,710000,678000,-32000
293846,10,38,678000,631000,-47000
293846,11,71,631000,602000,-29000
293846,12,NA,602000,602000,0
293846,13,81,602000,593000,-9000
293846,14,76,593000,599000,6000
293846,15,NA,599000,599000,0
293846,16,54,599000,591000,-8000
293846,17,7,591000,544000,-47000
293846,18,NA,544000,544000,0
293846,19,NA,544000,544000,0
293846,20,NA,544000,544000,0
293846,21,NA,544000,544000,0
293846,22,122,544000,553000,9000
293846,23,22,553000,527000,-26000
293846,24,NA,527000,527000,0
293854,1,40,498000,485000,-13000
293854,2,35,485000,460000,-25000
293854,3,45,460000,438000,-22000
293854,4,45,438000,420000,-18000
293854,5,NA,420000,420000,0
293854,6,NA,420000,420000,0
293854,7,NA,420000,420000,0
293854,8,NA,420000,420000,0
293854,9,NA,420000,420000,0
293854,10,NA,420000,420000,0
293854,11,NA,420000,420000,0
293854,12,NA,420000,420000,0
293854,13,NA,420000,420000,0
293854,14,NA,420000,420000,0
293854,15,NA,420000,420000,0
293854,16,NA,420000,420000,0
293854,17,NA,420000,420000,0
293854,18,NA,420000,420000,0
293854,19,NA,420000,420000,0
293854,20,NA,420000,420000,0
293854,21,NA,420000,420000,0
293854,22,NA,420000,420000,0
293854,23,NA,420000,420000,0
293854,24,NA,420000,420000,0
293871,1,81,835000,824000,-11000
293871,2,83,824000,807000,-17000
293871,3,76,807000,783000,-24000
293871,4,72,783000,753000,-30000
293871,5,84,753000,735000,-18000
293871,6,82,735000,723000,-12000
293871,7,72,723000,707000,-16000
293871,8,77,707000,695000,-12000
293871,9,65,695000,677000,-18000
293871,10,62,677000,652000,-25000
293871,11,72,652000,634000,-18000
293871,12,84,634000,630000,-4000
293871,13,131,630000,669000,39000
293871,14,NA,669000,669000,0
293871,15,56,669000,681000,12000
293871,16,95,681000,700000,19000
293871,17,87,700000,712000,12000
293871,18,102,712000,730000,18000
293871,19,89,730000,738000,8000
293871,20,64,738000,730000,-8000
293871,21,104,730000,735000,5000
293871,22,90,735000,739000,4000
293871,23,99,739000,748000,9000
293871,24,80,748000,745000,-3000
293883,1,38,400000,394000,-6000
293883,2,49,394000,392000,-2000
293883,3,50,392000,395000,3000
293883,4,9,395000,369000,-26000
293883,5,NA,369000,369000,0
293883,6,NA,369000,369000,0
293883,7,41,369000,352000,-17000
293883,8,42,352000,342000,-10000
293883,9,51,342000,344000,2000
293883,10,27,344000,336000,-8000
293883,11,43,336000,337000,1000
293883,12,45,337000,340000,3000
293883,13,NA,340000,340000,0
293883,14,21,340000,330000,-10000
293883,15,64,330000,340000,10000
293883,16,15,340000,330000,-10000
293883,17,NA,330000,330000,0
293883,18,NA,330000,330000,0
293883,19,NA,330000,330000,0
293883,20,NA,330000,330000,0
293883,21,NA,330000,330000,0
293883,22,NA,330000,330000,0
293883,23,44,330000,326000,-4000
293883,24,62,326000,338000,12000
293884,1,NA,557000,557000,0
293884,2,NA,557000,557000,0
293884,3,35,557000,534000,-23000
293884,4,93,534000,540000,6000
293884,5,39,540000,528000,-12000
293884,6,46,528000,510000,-18000
293884,7,115,510000,539000,29000
293884,8,62,539000,558000,19000
293884,9,62,558000,565000,7000
293884,10,62,565000,568000,3000
293884,11,87,568000,582000,14000
293884,12,79,582000,593000,11000
293884,13,64,593000,597000,4000
293884,14,NA,597000,597000,0
293884,15,72,597000,602000,5000
293884,16,80,602000,612000,10000
293884,17,52,612000,600000,-12000
293884,18,31,600000,564000,-36000
293884,19,40,564000,523000,-41000
293884,20,NA,523000,523000,0
293884,21,NA,523000,523000,0
293884,22,NA,523000,523000,0
293884,23,35,523000,478000,-45000
293884,24,NA,478000,478000,0
293957,1,79,830000,818000,-12000
293957,2,95,818000,809000,-9000
293957,3,106,809000,813000,4000
293957,4,119,813000,833000,20000
293957,5,81,833000,835000,2000
293957,6,54,835000,807000,-28000
293957,7,100,807000,791000,-16000
293957,8,48,791000,747000,-44000
293957,9,59,747000,698000,-49000
293957,10,71,698000,663000,-35000
293957,11,95,663000,656000,-7000
293957,12,47,656000,632000,-24000
293957,13,91,632000,632000,0
293957,14,NA,632000,632000,0
293957,15,67,632000,630000,-2000
293957,16,63,630000,621000,-9000
293957,17,64,621000,607000,-14000
293957,18,NA,607000,607000,0
293957,19,NA,607000,607000,0
293957,20,NA,607000,607000,0
293957,21,NA,607000,607000,0
293957,22,36,607000,574000,-33000
293957,23,NA,574000,574000,0
293957,24,NA,574000,574000,0
294013,1,NA,469000,469000,0
294013,2,NA,469000,469000,0
294013,3,NA,469000,469000,0
294013,4,NA,469000,469000,0
294013,5,39,469000,457000,-12000
294013,6,73,457000,463000,6000
294013,7,56,463000,468000,5000
294013,8,40,468000,461000,-7000
294013,9,28,461000,438000,-23000
294013,10,53,438000,425000,-13000
294013,11,NA,425000,425000,0
294013,12,NA,425000,425000,0
294013,13,NA,425000,425000,0
294013,14,NA,425000,425000,0
294013,15,NA,425000,425000,0
294013,16,NA,425000,425000,0
294013,17,NA,425000,425000,0
294013,18,NA,425000,425000,0
294013,19,NA,425000,425000,0
294013,20,17,425000,391000,-34000
294013,21,26,391000,357000,-34000
294013,22,42,357000,338000,-19000
294013,23,52,338000,336000,-2000
294013,24,39,336000,335000,-1000
294036,1,99,870000,869000,-1000
294036,2,NA,869000,869000,0
294036,3,72,869000,846000,-23000
294036,4,53,846000,797000,-49000
294036,5,69,797000,750000,-47000
294036,6,85,750000,721000,-29000
294036,7,124,721000,732000,11000
294036,8,90,732000,748000,16000
294036,9,72,748000,750000,2000
294036,10,39,750000,715000,-35000
294036,11,25,715000,648000,-67000
294036,12,NA,648000,648000,0
294036,13,NA,648000,648000,0
294036,14,NA,648000,648000,0
294036,15,NA,648000,648000,0
294036,16,27,648000,570000,-78000
294036,17,19,570000,487000,-83000
294036,18,74,487000,452000,-35000
294036,19,91,452000,464000,12000
294036,20,66,464000,486000,22000
294036,21,105,486000,537000,51000
294036,22,111,537000,604000,67000
294036,23,106,604000,665000,61000
294036,24,80,665000,697000,32000
294068,1,24,648000,611000,-37000
294068,2,56,611000,573000,-38000
294068,3,NA,573000,573000,0
294068,4,51,573000,536000,-37000
294068,5,78,536000,527000,-9000
294068,6,43,527000,512000,-15000
294068,7,32,512000,487000,-25000
294068,8,59,487000,473000,-14000
294068,9,56,473000,465000,-8000
294068,10,18,465000,433000,-32000
294068,11,NA,433000,433000,0
294068,12,65,433000,425000,-8000
294068,13,50,425000,422000,-3000
294068,14,NA,422000,422000,0
294068,15,67,422000,433000,11000
294068,16,97,433000,474000,41000
294068,17,55,474000,501000,27000
294068,18,NA,501000,501000,0
294068,19,71,501000,523000,22000
294068,20,58,523000,533000,10000
294068,21,77,533000,546000,13000
294068,22,49,546000,539000,-7000
294068,23,77,539000,544000,5000
294068,24,56,544000,539000,-5000
294092,1,27,335000,326000,-9000
294092,2,NA,326000,326000,0
294092,3,NA,326000,326000,0
294092,4,NA,326000,326000,0
294092,5,NA,326000,326000,0
294092,6,NA,326000,326000,0
294092,7,41,326000,321000,-5000
294092,8,61,321000,335000,14000
294092,9,30,335000,338000,3000
294092,10,50,338000,347000,9000
294092,11,18,347000,337000,-10000
294092,12,NA,337000,337000,0
294092,13,NA,337000,337000,0
294092,14,NA,337000,337000,0
294092,15,NA,337000,337000,0
294092,16,NA,337000,337000,0
294092,17,NA,337000,337000,0
294092,18,NA,337000,337000,0
294092,19,NA,337000,337000,0
294092,20,NA,337000,337000,0
294092,21,NA,337000,337000,0
294092,22,NA,337000,337000,0
294092,23,NA,337000,337000,0
294092,24,14,337000,309000,-28000
294101,1,28,427000,411000,-16000
294101,2,NA,411000,411000,0
294101,3,69,411000,415000,4000
294101,4,81,415000,442000,27000
294101,5,98,442000,494000,52000
294101,6,67,494000,534000,40000
294101,7,86,534000,575000,41000
294101,8,92,575000,614000,39000
294101,9,96,614000,651000,37000
294101,10,43,651000,645000,-6000
294101,11,NA,645000,645000,0
294101,12,NA,645000,645000,0
294101,13,NA,645000,645000,0
294101,14,NA,645000,645000,0
294101,15,NA,645000,645000,0
294101,16,NA,645000,645000,0
294101,17,NA,645000,645000,0
294101,18,NA,645000,645000,0
294101,19,NA,645000,645000,0
294101,20,84,645000,646000,1000
294101,21,65,646000,635000,-11000
294101,22,NA,635000,635000,0
294101,23,NA,635000,635000,0
294101,24,NA,635000,635000,0
294125,1,77,415000,436000,21000
294125,2,65,436000,463000,27000
294125,3,55,463000,481000,18000
294125,4,42,481000,480000,-1000
294125,5,NA,480000,480000,0
294125,6,NA,480000,480000,0
294125,7,NA,480000,480000,0
294125,8,NA,480000,480000,0
294125,9,NA,480000,480000,0
294125,10,NA,480000,480000,0
294125,11,NA,480000,480000,0
294125,12,NA,480000,480000,0
294125,13,NA,480000,480000,0
294125,14,NA,480000,480000,0
294125,15,NA,480000,480000,0
294125,16,NA,480000,480000,0
294125,17,NA,480000,480000,0
294125,18,NA,480000,480000,0
294125,19,NA,480000,480000,0
294125,20,NA,480000,480000,0
294125,21,NA,480000,480000,0
294125,22,NA,480000,480000,0
294125,23,NA,480000,480000,0
294125,24,NA,480000,480000,0
294168,1,NA,503000,503000,0
294168,2,NA,503000,503000,0
294168,3,NA,503000,503000,0
294168,4,NA,503000,503000,0
294168,5,NA,503000,503000,0
294168,6,NA,503000,503000,0
294168,7,NA,503000,503000,0
294168,8,NA,503000,503000,0
294168,9,NA,503000,503000,0
294168,10,NA,503000,503000,0
294168,11,NA,503000,503000,0
294168,12,NA,503000,503000,0
294168,13,NA,503000,503000,0
294168,14,NA,503000,503000,0
294168,15,NA,503000,503000,0
294168,16,NA,503000,503000,0
294168,17,NA,503000,503000,0
294168,18,NA,503000,503000,0
294168,19,NA,503000,503000,0
294168,20,NA,503000,503000,0
294168,21,NA,503000,503000,0
294168,22,NA,503000,503000,0
294168,23,NA,503000,503000,0
294168,24,NA,503000,503000,0
294199,1,NA,698000,698000,0
294199,2,NA,698000,698000,0
294199,3,NA,698000,698000,0
294199,4,NA,698000,698000,0
294199,5,NA,698000,698000,0
294199,6,NA,698000,698000,0
294199,7,NA,698000,698000,0
294199,8,NA,698000,698000,0
294199,9,NA,698000,698000,0
294199,10,NA,698000,698000,0
294199,11,NA,698000,698000,0
294199,12,NA,698000,698000,0
294199,13,NA,698000,698000,0
294199,14,NA,698000,698000,0
294199,15,NA,698000,698000,0
294199,16,NA,698000,698000,0
294199,17,NA,698000,698000,0
294199,18,NA,698000,698000,0
294199,19,NA,698000,698000,0
294199,20,NA,698000,698000,0
294199,21,NA,698000,698000,0
294199,22,NA,698000,698000,0
294199,23,NA,698000,698000,0
294199,24,99,698000,706000,8000
294266,1,NA,602000,602000,0
294266,2,NA,602000,602000,0
294266,3,NA,602000,602000,0
294266,4,NA,602000,602000,0
294266,5,NA,602000,602000,0
294266,6,NA,602000,602000,0
294266,7,NA,602000,602000,0
294266,8,NA,602000,602000,0
294266,9,67,602000,598000,-4000
294266,10,NA,598000,598000,0
294266,11,73,598000,597000,-1000
294266,12,NA,597000,597000,0
294266,13,63,597000,590000,-7000
294266,14,57,590000,581000,-9000
294266,15,90,581000,589000,8000
294266,16,75,589000,599000,10000
294266,17,56,599000,594000,-5000
294266,18,NA,594000,594000,0
294266,19,NA,594000,594000,0
294266,20,NA,594000,594000,0
294266,21,75,594000,595000,1000
294266,22,50,595000,580000,-15000
294266,23,80,580000,577000,-3000
294266,24,48,577000,559000,-18000
294305,1,48,804000,771000,-33000
294305,2,NA,771000,771000,0
294305,3,82,771000,741000,-30000
294305,4,100,741000,731000,-10000
294305,5,86,731000,728000,-3000
294305,6,81,728000,728000,0
294305,7,88,728000,731000,3000
294305,8,130,731000,765000,34000
294305,9,105,765000,795000,30000
294305,10,86,795000,807000,12000
294305,11,102,807000,820000,13000
294305,12,94,820000,822000,2000
294305,13,90,822000,814000,-8000
294305,14,90,814000,809000,-5000
294305,15,NA,809000,809000,0
294305,16,NA,809000,809000,0
294305,17,81,809000,794000,-15000
294305,18,101,794000,789000,-5000
294305,19,106,789000,795000,6000
294305,20,134,795000,828000,33000
294305,21,77,828000,835000,7000
294305,22,87,835000,831000,-4000
294305,23,102,831000,828000,-3000
294305,24,119,828000,835000,7000
294307,1,90,942000,928000,-14000
294307,2,111,928000,921000,-7000
294307,3,122,921000,928000,7000
294307,4,125,928000,944000,16000
294307,5,118,944000,962000,18000
294307,6,75,962000,948000,-14000
294307,7,77,948000,912000,-36000
294307,8,83,912000,870000,-42000
294307,9,96,870000,838000,-32000
294307,10,79,838000,805000,-33000
294307,11,114,805000,804000,-1000
294307,12,NA,804000,804000,0
294307,13,123,804000,825000,21000
294307,14,109,825000,853000,28000
294307,15,116,853000,880000,27000
294307,16,137,880000,921000,41000
294307,17,96,921000,933000,12000
294307,18,89,933000,922000,-11000
294307,19,97,922000,905000,-17000
294307,20,133,905000,911000,6000
294307,21,126,911000,926000,15000
294307,22,68,926000,908000,-18000
294307,23,100,908000,893000,-15000
294307,24,91,893000,869000,-24000
294318,1,93,866000,861000,-5000
294318,2,75,861000,840000,-21000
294318,3,82,840000,814000,-26000
294318,4,48,814000,763000,-51000
294318,5,79,763000,726000,-37000
294318,6,74,726000,698000,-28000
294318,7,65,698000,671000,-27000
294318,8,70,671000,651000,-20000
294318,9,97,651000,657000,6000
294318,10,85,657000,665000,8000
294318,11,84,665000,676000,11000
294318,12,90,676000,690000,14000
294318,13,84,690000,700000,10000
294318,14,98,700000,719000,19000
294318,15,NA,719000,719000,0
294318,16,36,719000,694000,-25000
294318,17,87,694000,680000,-14000
294318,18,92,680000,678000,-2000
294318,19,36,678000,646000,-32000
294318,20,77,646000,627000,-19000
294318,21,63,627000,611000,-16000
294318,22,90,611000,612000,1000
294318,23,106,612000,637000,25000
294318,24,75,637000,653000,16000
294429,1,NA,687000,687000,0
294429,2,NA,687000,687000,0
294429,3,NA,687000,687000,0
294429,4,NA,687000,687000,0
294429,5,NA,687000,687000,0
294429,6,NA,687000,687000,0
294429,7,NA,687000,687000,0
294429,8,NA,687000,687000,0
294429,9,NA,687000,687000,0
294429,10,NA,687000,687000,0
294429,11,NA,687000,687000,0
294429,12,NA,687000,687000,0
294429,13,NA,687000,687000,0
294429,14,NA,687000,687000,0
294429,15,NA,687000,687000,0
294429,16,NA,687000,687000,0
294429,17,NA,687000,687000,0
294429,18,NA,687000,687000,0
294429,19,NA,687000,687000,0
294429,20,NA,687000,687000,0
294429,21,NA,687000,687000,0
294429,22,NA,687000,687000,0
294429,23,NA,687000,687000,0
294429,24,NA,687000,687000,0
294469,1,62,477000,482000,5000
294469,2,34,482000,470000,-12000
294469,3,68,470000,472000,2000
294469,4,63,472000,478000,6000
294469,5,58,478000,484000,6000
294469,6,46,484000,481000,-3000
294469,7,36,481000,465000,-16000
294469,8,33,465000,438000,-27000
294469,9,40,438000,412000,-26000
294469,10,29,412000,382000,-30000
294469,11,53,382000,371000,-11000
294469,12,58,371000,377000,6000
294469,13,58,377000,392000,15000
294469,14,84,392000,432000,40000
294469,15,NA,432000,432000,0
294469,16,40,432000,449000,17000
294469,17,50,449000,455000,6000
294469,18,42,455000,447000,-8000
294469,19,35,447000,428000,-19000
294469,20,52,428000,414000,-14000
294469,21,NA,414000,414000,0
294469,22,54,414000,411000,-3000
294469,23,75,411000,429000,18000
294469,24,50,429000,439000,10000
294472,1,NA,342000,342000,0
294472,2,NA,342000,342000,0
294472,3,NA,342000,342000,0
294472,4,NA,342000,342000,0
294472,5,NA,342000,342000,0
294472,6,NA,342000,342000,0
294472,7,102,342000,386000,44000
294472,8,86,386000,447000,61000
294472,9,75,447000,504000,57000
294472,10,84,504000,553000,49000
294472,11,30,553000,554000,1000
294472,12,66,554000,547000,-7000
294472,13,NA,547000,547000,0
294472,14,68,547000,545000,-2000
294472,15,31,545000,518000,-27000
294472,16,56,518000,498000,-20000
294472,17,103,498000,519000,21000
294472,18,122,519000,576000,57000
294472,19,100,576000,635000,59000
294472,20,90,635000,684000,49000
294472,21,77,684000,709000,25000
294472,22,65,709000,703000,-6000
294472,23,75,703000,688000,-15000
294472,24,40,688000,645000,-43000
294504,1,NA,410000,410000,0
294504,2,NA,410000,410000,0
294504,3,16,410000,386000,-24000
294504,4,NA,386000,386000,0
294504,5,NA,386000,386000,0
294504,6,NA,386000,386000,0
294504,7,NA,386000,386000,0
294504,8,NA,386000,386000,0
294504,9,NA,386000,386000,0
294504,10,NA,386000,386000,0
294504,11,NA,386000,386000,0
294504,12,NA,386000,386000,0
294504,13,NA,386000,386000,0
294504,14,NA,386000,386000,0
294504,15,NA,386000,386000,0
294504,16,NA,386000,386000,0
294504,17,NA,386000,386000,0
294504,18,NA,386000,386000,0
294504,19,NA,386000,386000,0
294504,20,NA,386000,386000,0
294504,21,NA,386000,386000,0
294504,22,NA,386000,386000,0
294504,23,NA,386000,386000,0
294504,24,NA,386000,386000,0
294508,1,NA,508000,508000,0
294508,2,101,508000,539000,31000
294508,3,57,539000,557000,18000
294508,4,37,557000,547000,-10000
294508,5,34,547000,518000,-29000
294508,6,17,518000,467000,-51000
294508,7,83,467000,452000,-15000
294508,8,67,452000,456000,4000
294508,9,59,456000,467000,11000
294508,10,NA,467000,467000,0
294508,11,NA,467000,467000,0
294508,12,NA,467000,467000,0
294508,13,29,467000,457000,-10000
294508,14,52,457000,454000,-3000
294508,15,NA,454000,454000,0
294508,16,48,454000,443000,-11000
294508,17,64,443000,443000,0
294508,18,102,443000,479000,36000
294508,19,78,479000,520000,41000
294508,20,82,520000,559000,39000
294508,21,41,559000,565000,6000
294508,22,32,565000,540000,-25000
294508,23,72,540000,524000,-16000
294508,24,63,524000,512000,-12000
294518,1,45,500000,491000,-9000
294518,2,82,491000,503000,12000
294518,3,36,503000,495000,-8000
294518,4,91,495000,513000,18000
294518,5,120,513000,569000,56000
294518,6,85,569000,619000,50000
294518,7,72,619000,646000,27000
294518,8,74,646000,662000,16000
294518,9,118,662000,694000,32000
294518,10,95,694000,718000,24000
294518,11,44,718000,704000,-14000
294518,12,NA,704000,704000,0
294518,13,40,704000,664000,-40000
294518,14,61,664000,628000,-36000
294518,15,82,628000,607000,-21000
294518,16,121,607000,632000,25000
294518,17,54,632000,638000,6000
294518,18,98,638000,661000,23000
294518,19,97,661000,687000,26000
294518,20,74,687000,696000,9000
294518,21,62,696000,683000,-13000
294518,22,46,683000,651000,-32000
294518,23,71,651000,624000,-27000
294518,24,84,624000,611000,-13000
294557,1,60,732000,714000,-18000
294557,2,100,714000,714000,0
294557,3,79,714000,712000,-2000
294557,4,91,712000,716000,4000
294557,5,87,716000,723000,7000
294557,6,57,723000,709000,-14000
294557,7,63,709000,684000,-25000
294557,8,68,684000,659000,-25000
294557,9,58,659000,629000,-30000
294557,10,88,629000,621000,-8000
294557,11,NA,621000,621000,0
294557,12,67,621000,614000,-7000
294557,13,102,614000,633000,19000
294557,14,NA,633000,633000,0
294557,15,82,633000,652000,19000
294557,16,99,652000,681000,29000
294557,17,78,681000,695000,14000
294557,18,89,695000,707000,12000
294557,19,53,707000,690000,-17000
294557,20,69,690000,669000,-21000
294557,21,113,669000,678000,9000
294557,22,99,678000,698000,20000
294557,23,72,698000,704000,6000
294557,24,68,704000,696000,-8000
294592,1,69,600000,600000,0
294592,2,40,600000,578000,-22000
294592,3,70,578000,566000,-12000
294592,4,62,566000,555000,-11000
294592,5,66,555000,551000,-4000
294592,6,29,551000,524000,-27000
294592,7,81,524000,523000,-1000
294592,8,42,523000,508000,-15000
294592,9,82,508000,515000,7000
294592,10,63,515000,522000,7000
294592,11,43,522000,515000,-7000
294592,12,83,515000,524000,9000
294592,13,54,524000,525000,1000
294592,14,51,525000,519000,-6000
294592,15,NA,519000,519000,0
294592,16,51,519000,507000,-12000
294592,17,56,507000,497000,-10000
294592,18,57,497000,488000,-9000
294592,19,80,488000,499000,11000
294592,20,55,499000,505000,6000
294592,21,57,505000,508000,3000
294592,22,74,508000,518000,10000
294592,23,49,518000,515000,-3000
294592,24,NA,515000,515000,0
294596,1,NA,638000,638000,0
294596,2,NA,638000,638000,0
294596,3,NA,638000,638000,0
294596,4,NA,638000,638000,0
294596,5,NA,638000,638000,0
294596,6,68,638000,633000,-5000
294596,7,56,633000,615000,-18000
294596,8,35,615000,577000,-38000
294596,9,44,577000,536000,-41000
294596,10,NA,536000,536000,0
294596,11,NA,536000,536000,0
294596,12,NA,536000,536000,0
294596,13,NA,536000,536000,0
294596,14,NA,536000,536000,0
294596,15,NA,536000,536000,0
294596,16,NA,536000,536000,0
294596,17,NA,536000,536000,0
294596,18,NA,536000,536000,0
294596,19,NA,536000,536000,0
294596,20,NA,536000,536000,0
294596,21,NA,536000,536000,0
294596,22,60,536000,509000,-27000
294596,23,58,509000,492000,-17000
294596,24,60,492000,484000,-8000
294613,1,72,727000,718000,-9000
294613,2,89,718000,717000,-1000
294613,3,63,717000,701000,-16000
294613,4,64,701000,678000,-23000
294613,5,44,678000,639000,-39000
294613,6,85,639000,624000,-15000
294613,7,95,624000,630000,6000
294613,8,103,630000,658000,28000
294613,9,102,658000,696000,38000
294613,10,89,696000,725000,29000
294613,11,96,725000,747000,22000
294613,12,NA,747000,747000,0
294613,13,NA,747000,747000,0
294613,14,48,747000,733000,-14000
294613,15,95,733000,725000,-8000
294613,16,87,725000,720000,-5000
294613,17,64,720000,702000,-18000
294613,18,102,702000,704000,2000
294613,19,101,704000,721000,17000
294613,20,43,721000,701000,-20000
294613,21,67,701000,678000,-23000
294613,22,49,678000,641000,-37000
294613,23,26,641000,580000,-61000
294613,24,NA,580000,580000,0
294624,1,NA,406000,406000,0
294624,2,NA,406000,406000,0
294624,3,NA,406000,406000,0
294624,4,NA,406000,406000,0
294624,5,55,406000,411000,5000
294624,6,NA,411000,411000,0
294624,7,NA,411000,411000,0
294624,8,NA,411000,411000,0
294624,9,NA,411000,411000,0
294624,10,NA,411000,411000,0
294624,11,NA,411000,411000,0
294624,12,NA,411000,411000,0
294624,13,NA,411000,411000,0
294624,14,NA,411000,411000,0
294624,15,NA,411000,411000,0
294624,16,NA,411000,411000,0
294624,17,NA,411000,411000,0
294624,18,NA,411000,411000,0
294624,19,NA,411000,411000,0
294624,20,NA,411000,411000,0
294624,21,NA,411000,411000,0
294624,22,NA,411000,411000,0
294624,23,NA,411000,411000,0
294624,24,NA,411000,411000,0
294643,1,NA,421000,421000,0
294643,2,27,421000,405000,-16000
294643,3,23,405000,375000,-30000
294643,4,22,375000,340000,-35000
294643,5,15,340000,301000,-39000
294643,6,NA,301000,301000,0
294643,7,27,301000,273000,-28000
294643,8,NA,273000,273000,0
294643,9,NA,273000,273000,0
294643,10,NA,273000,273000,0
294643,11,NA,273000,273000,0
294643,12,NA,273000,273000,0
294643,13,NA,273000,273000,0
294643,14,12,273000,245000,-28000
294643,15,NA,245000,245000,0
294643,16,NA,245000,245000,0
294643,17,NA,245000,245000,0
294643,18,NA,245000,245000,0
294643,19,NA,245000,245000,0
294643,20,NA,245000,245000,0
294643,21,NA,245000,245000,0
294643,22,NA,245000,245000,0
294643,23,48,245000,243000,-2000
294643,24,24,243000,240000,-3000
294654,1,NA,367000,367000,0
294654,2,NA,367000,367000,0
294654,3,NA,367000,367000,0
294654,4,NA,367000,367000,0
294654,5,NA,367000,367000,0
294654,6,NA,367000,367000,0
294654,7,NA,367000,367000,0
294654,8,NA,367000,367000,0
294654,9,NA,367000,367000,0
294654,10,NA,367000,367000,0
294654,11,NA,367000,367000,0
294654,12,NA,367000,367000,0
294654,13,NA,367000,367000,0
294654,14,NA,367000,367000,0
294654,15,NA,367000,367000,0
294654,16,NA,367000,367000,0
294654,17,NA,367000,367000,0
294654,18,NA,367000,367000,0
294654,19,NA,367000,367000,0
294654,20,NA,367000,367000,0
294654,21,NA,367000,367000,0
294654,22,NA,367000,367000,0
294654,23,NA,367000,367000,0
294654,24,NA,367000,367000,0
294674,1,53,798000,769000,-29000
294674,2,78,769000,741000,-28000
294674,3,82,741000,719000,-22000
294674,4,91,719000,712000,-7000
294674,5,76,712000,706000,-6000
294674,6,82,706000,706000,0
294674,7,70,706000,696000,-10000
294674,8,80,696000,688000,-8000
294674,9,62,688000,669000,-19000
294674,10,99,669000,672000,3000
294674,11,NA,672000,672000,0
294674,12,NA,672000,672000,0
294674,13,117,672000,700000,28000
294674,14,102,700000,737000,37000
294674,15,NA,737000,737000,0
294674,16,106,737000,773000,36000
294674,17,85,773000,790000,17000
294674,18,63,790000,774000,-16000
294674,19,85,774000,756000,-18000
294674,20,82,756000,738000,-18000
294674,21,71,738000,715000,-23000
294674,22,86,715000,703000,-12000
294674,23,81,703000,697000,-6000
294674,24,54,697000,671000,-26000
294685,1,NA,614000,614000,0
294685,2,NA,614000,614000,0
294685,3,NA,614000,614000,0
294685,4,NA,614000,614000,0
294685,5,NA,614000,614000,0
294685,6,NA,614000,614000,0
294685,7,NA,614000,614000,0
294685,8,NA,614000,614000,0
294685,9,NA,614000,614000,0
294685,10,NA,614000,614000,0
294685,11,NA,614000,614000,0
294685,12,NA,614000,614000,0
294685,13,NA,614000,614000,0
294685,14,NA,614000,614000,0
294685,15,NA,614000,614000,0
294685,16,NA,614000,614000,0
294685,17,NA,614000,614000,0
294685,18,NA,614000,614000,0
294685,19,NA,614000,614000,0
294685,20,NA,614000,614000,0
294685,21,NA,614000,614000,0
294685,22,NA,614000,614000,0
294685,23,NA,614000,614000,0
294685,24,NA,614000,614000,0
294733,1,NA,593000,593000,0
294733,2,NA,593000,593000,0
294733,3,NA,593000,593000,0
294733,4,NA,593000,593000,0
294733,5,NA,593000,593000,0
294733,6,NA,593000,593000,0
294733,7,NA,593000,593000,0
294733,8,NA,593000,593000,0
294733,9,NA,593000,593000,0
294733,10,NA,593000,593000,0
294733,11,NA,593000,593000,0
294733,12,NA,593000,593000,0
294733,13,NA,593000,593000,0
294733,14,NA,593000,593000,0
294733,15,NA,593000,593000,0
294733,16,NA,593000,593000,0
294733,17,NA,593000,593000,0
294733,18,NA,593000,593000,0
294733,19,NA,593000,593000,0
294733,20,NA,593000,593000,0
294733,21,NA,593000,593000,0
294733,22,NA,593000,593000,0
294733,23,NA,593000,593000,0
294733,24,NA,593000,593000,0
294859,1,93,613000,629000,16000
294859,2,77,629000,645000,16000
294859,3,39,645000,628000,-17000
294859,4,NA,628000,628000,0
294859,5,NA,628000,628000,0
294859,6,NA,628000,628000,0
294859,7,NA,628000,628000,0
294859,8,NA,628000,628000,0
294859,9,NA,628000,628000,0
294859,10,NA,628000,628000,0
294859,11,NA,628000,628000,0
294859,12,NA,628000,628000,0
294859,13,NA,628000,628000,0
294859,14,NA,628000,628000,0
294859,15,NA,628000,628000,0
294859,16,NA,628000,628000,0
294859,17,90,628000,626000,-2000
294859,18,55,626000,610000,-16000
294859,19,NA,610000,610000,0
294859,20,NA,610000,610000,0
294859,21,49,610000,583000,-27000
294859,22,77,583000,572000,-11000
294859,23,87,572000,582000,10000
294859,24,66,582000,583000,1000
294877,1,91,752000,755000,3000
294877,2,93,755000,762000,7000
294877,3,102,762000,776000,14000
294877,4,99,776000,790000,14000
294877,5,83,790000,793000,3000
294877,6,60,793000,771000,-22000
294877,7,67,771000,738000,-33000
294877,8,83,738000,714000,-24000
294877,9,70,714000,689000,-25000
294877,10,90,689000,682000,-7000
294877,11,83,682000,683000,1000
294877,12,81,683000,685000,2000
294877,13,NA,685000,685000,0
294877,14,84,685000,693000,8000
294877,15,65,693000,684000,-9000
294877,16,68,684000,669000,-15000
294877,17,NA,669000,669000,0
294877,18,92,669000,667000,-2000
294877,19,83,667000,669000,2000
294877,20,68,669000,664000,-5000
294877,21,85,664000,666000,2000
294877,22,105,666000,686000,20000
294877,23,74,686000,691000,5000
294877,24,160,691000,747000,56000
295067,1,79,698000,697000,-1000
295067,2,94,697000,706000,9000
295067,3,106,706000,730000,24000
295067,4,62,730000,728000,-2000
295067,5,66,728000,712000,-16000
295067,6,48,712000,677000,-35000
295067,7,60,677000,639000,-38000
295067,8,78,639000,616000,-23000
295067,9,42,616000,585000,-31000
295067,10,86,585000,579000,-6000
295067,11,97,579000,600000,21000
295067,12,NA,600000,600000,0
295067,13,92,600000,628000,28000
295067,14,NA,628000,628000,0
295067,15,NA,628000,628000,0
295067,16,76,628000,649000,21000
295067,17,56,649000,648000,-1000
295067,18,76,648000,642000,-6000
295067,19,NA,642000,642000,0
295067,20,68,642000,630000,-12000
295067,21,54,630000,607000,-23000
295067,22,87,607000,605000,-2000
295067,23,83,605000,613000,8000
295067,24,60,613000,607000,-6000
295136,1,106,768000,781000,13000
295136,2,84,781000,786000,5000
295136,3,77,786000,778000,-8000
295136,4,76,778000,761000,-17000
295136,5,75,761000,741000,-20000
295136,6,78,741000,721000,-20000
295136,7,118,721000,734000,13000
295136,8,90,734000,748000,14000
295136,9,92,748000,760000,12000
295136,10,117,760000,787000,27000
295136,11,106,787000,812000,25000
295136,12,136,812000,852000,40000
295136,13,110,852000,883000,31000
295136,14,93,883000,898000,15000
295136,15,NA,898000,898000,0
295136,16,74,898000,880000,-18000
295136,17,116,880000,873000,-7000
295136,18,67,873000,840000,-33000
295136,19,109,840000,827000,-13000
295136,20,39,827000,780000,-47000
295136,21,83,780000,747000,-33000
295136,22,63,747000,707000,-40000
295136,23,89,707000,689000,-18000
295136,24,69,689000,667000,-22000
295203,1,70,615000,614000,-1000
295203,2,66,614000,610000,-4000
295203,3,NA,610000,610000,0
295203,4,NA,610000,610000,0
295203,5,NA,610000,610000,0
295203,6,NA,610000,610000,0
295203,7,67,610000,603000,-7000
295203,8,50,603000,584000,-19000
295203,9,88,584000,586000,2000
295203,10,54,586000,576000,-10000
295203,11,102,576000,596000,20000
295203,12,68,596000,606000,10000
295203,13,66,606000,609000,3000
295203,14,64,609000,607000,-2000
295203,15,NA,607000,607000,0
295203,16,97,607000,623000,16000
295203,17,42,623000,607000,-16000
295203,18,22,607000,562000,-45000
295203,19,91,562000,552000,-10000
295203,20,54,552000,538000,-14000
295203,21,64,538000,529000,-9000
295203,22,91,529000,548000,19000
295203,23,34,548000,541000,-7000
295203,24,81,541000,543000,2000
295222,1,NA,213000,213000,0
295222,2,NA,213000,213000,0
295222,3,NA,213000,213000,0
295222,4,NA,213000,213000,0
295222,5,NA,213000,213000,0
295222,6,NA,213000,213000,0
295222,7,NA,213000,213000,0
295222,8,NA,213000,213000,0
295222,9,NA,213000,213000,0
295222,10,NA,213000,213000,0
295222,11,NA,213000,213000,0
295222,12,NA,213000,213000,0
295222,13,NA,213000,213000,0
295222,14,NA,213000,213000,0
295222,15,NA,213000,213000,0
295222,16,NA,213000,213000,0
295222,17,NA,213000,213000,0
295222,18,38,213000,222000,9000
295222,19,26,222000,228000,6000
295222,20,48,228000,247000,19000
295222,21,NA,247000,247000,0
295222,22,NA,247000,247000,0
295222,23,NA,247000,247000,0
295222,24,63,247000,281000,34000
295265,1,73,522000,531000,9000
295265,2,59,531000,537000,6000
295265,3,85,537000,557000,20000
295265,4,126,557000,613000,56000
295265,5,72,613000,648000,35000
295265,6,93,648000,681000,33000
295265,7,71,681000,694000,13000
295265,8,116,694000,722000,28000
295265,9,106,722000,749000,27000
295265,10,9,749000,710000,-39000
295265,11,NA,710000,710000,0
295265,12,NA,710000,710000,0
295265,13,62,710000,668000,-42000
295265,14,48,668000,622000,-46000
295265,15,NA,622000,622000,0
295265,16,90,622000,602000,-20000
295265,17,25,602000,559000,-43000
295265,18,NA,559000,559000,0
295265,19,68,559000,541000,-18000
295265,20,22,541000,502000,-39000
295265,21,73,502000,489000,-13000
295265,22,35,489000,464000,-25000
295265,23,NA,464000,464000,0
295265,24,30,464000,433000,-31000
295340,1,99,641000,660000,19000
295340,2,101,660000,691000,31000
295340,3,118,691000,740000,49000
295340,4,96,740000,776000,36000
295340,5,91,776000,796000,20000
295340,6,72,796000,791000,-5000
295340,7,83,791000,776000,-15000
295340,8,67,776000,747000,-29000
295340,9,109,747000,744000,-3000
295340,10,77,744000,736000,-8000
295340,11,77,736000,726000,-10000
295340,12,NA,726000,726000,0
295340,13,71,726000,710000,-16000
295340,14,75,710000,698000,-12000
295340,15,89,698000,692000,-6000
295340,16,94,692000,700000,8000
295340,17,89,700000,710000,10000
295340,18,69,710000,706000,-4000
295340,19,102,706000,717000,11000
295340,20,115,717000,743000,26000
295340,21,153,743000,805000,62000
295340,22,68,805000,824000,19000
295340,23,105,824000,840000,16000
295340,24,87,840000,834000,-6000
295342,1,107,807000,817000,10000
295342,2,93,817000,824000,7000
295342,3,81,824000,817000,-7000
295342,4,98,817000,813000,-4000
295342,5,99,813000,814000,1000
295342,6,78,814000,802000,-12000
295342,7,101,802000,800000,-2000
295342,8,108,800000,810000,10000
295342,9,95,810000,815000,5000
295342,10,66,815000,797000,-18000
295342,11,123,797000,806000,9000
295342,12,NA,806000,806000,0
295342,13,77,806000,797000,-9000
295342,14,87,797000,790000,-7000
295342,15,73,790000,771000,-19000
295342,16,79,771000,753000,-18000
295342,17,38,753000,702000,-51000
295342,18,NA,702000,702000,0
295342,19,86,702000,674000,-28000
295342,20,127,674000,692000,18000
295342,21,92,692000,713000,21000
295342,22,105,713000,743000,30000
295342,23,78,743000,757000,14000
295342,24,82,757000,754000,-3000
295344,1,118,659000,690000,31000
295344,2,89,690000,720000,30000
295344,3,22,720000,693000,-27000
295344,4,96,693000,685000,-8000
295344,5,110,685000,700000,15000
295344,6,98,700000,719000,19000
295344,7,96,719000,741000,22000
295344,8,NA,741000,741000,0
295344,9,NA,741000,741000,0
295344,10,65,741000,742000,1000
295344,11,120,742000,762000,20000
295344,12,74,762000,758000,-4000
295344,13,111,758000,770000,12000
295344,14,93,770000,784000,14000
295344,15,NA,784000,784000,0
295344,16,87,784000,788000,4000
295344,17,65,788000,767000,-21000
295344,18,93,767000,756000,-11000
295344,19,86,756000,745000,-11000
295344,20,108,745000,753000,8000
295344,21,78,753000,752000,-1000
295344,22,110,752000,767000,15000
295344,23,43,767000,742000,-25000
295344,24,96,742000,728000,-14000
295446,1,43,455000,448000,-7000
295446,2,91,448000,472000,24000
295446,3,73,472000,502000,30000
295446,4,86,502000,540000,38000
295446,5,38,540000,545000,5000
295446,6,61,545000,546000,1000
295446,7,81,546000,553000,7000
295446,8,39,553000,538000,-15000
295446,9,33,538000,506000,-32000
295446,10,59,506000,487000,-19000
295446,11,57,487000,475000,-12000
295446,12,64,475000,473000,-2000
295446,13,NA,473000,473000,0
295446,14,32,473000,461000,-12000
295446,15,58,461000,457000,-4000
295446,16,56,457000,455000,-2000
295446,17,41,455000,445000,-10000
295446,18,50,445000,436000,-9000
295446,19,84,436000,456000,20000
295446,20,44,456000,460000,4000
295446,21,59,460000,467000,7000
295446,22,32,467000,455000,-12000
295446,23,42,455000,437000,-18000
295446,24,29,437000,406000,-31000
295461,1,62,725000,709000,-16000
295461,2,103,709000,713000,4000
295461,3,89,713000,721000,8000
295461,4,85,721000,726000,5000
295461,5,62,726000,715000,-11000
295461,6,NA,715000,715000,0
295461,7,86,715000,709000,-6000
295461,8,78,709000,699000,-10000
295461,9,71,699000,685000,-14000
295461,10,43,685000,650000,-35000
295461,11,66,650000,622000,-28000
295461,12,56,622000,592000,-30000
295461,13,73,592000,576000,-16000
295461,14,71,576000,574000,-2000
295461,15,NA,574000,574000,0
295461,16,90,574000,591000,17000
295461,17,85,591000,613000,22000
295461,18,51,613000,612000,-1000
295461,19,77,612000,613000,1000
295461,20,65,613000,607000,-6000
295461,21,44,607000,581000,-26000
295461,22,104,581000,590000,9000
295461,23,80,590000,604000,14000
295461,24,85,604000,620000,16000
295467,1,107,916000,917000,1000
295467,2,73,917000,894000,-23000
295467,3,111,894000,883000,-11000
295467,4,89,883000,866000,-17000
295467,5,86,866000,846000,-20000
295467,6,99,846000,836000,-10000
295467,7,91,836000,826000,-10000
295467,8,90,826000,815000,-11000
295467,9,83,815000,800000,-15000
295467,10,117,800000,807000,7000
295467,11,123,807000,831000,24000
295467,12,104,831000,851000,20000
295467,13,129,851000,883000,32000
295467,14,83,883000,893000,10000
295467,15,NA,893000,893000,0
295467,16,109,893000,897000,4000
295467,17,93,897000,886000,-11000
295467,18,71,886000,854000,-32000
295467,19,69,854000,810000,-44000
295467,20,107,810000,793000,-17000
295467,21,90,793000,781000,-12000
295467,22,45,781000,742000,-39000
295467,23,51,742000,694000,-48000
295467,24,NA,694000,694000,0
295518,1,110,977000,975000,-2000
295518,2,79,975000,949000,-26000
295518,3,136,949000,950000,1000
295518,4,74,950000,924000,-26000
295518,5,NA,924000,924000,0
295518,6,NA,924000,924000,0
295518,7,94,924000,898000,-26000
295518,8,129,898000,901000,3000
295518,9,112,901000,909000,8000
295518,10,124,909000,924000,15000
295518,11,108,924000,936000,12000
295518,12,87,936000,925000,-11000
295518,13,95,925000,905000,-20000
295518,14,124,905000,909000,4000
295518,15,NA,909000,909000,0
295518,16,113,909000,913000,4000
295518,17,115,913000,921000,8000
295518,18,88,921000,914000,-7000
295518,19,130,914000,924000,10000
295518,20,87,924000,913000,-11000
295518,21,112,913000,908000,-5000
295518,22,92,908000,894000,-14000
295518,23,80,894000,867000,-27000
295518,24,NA,867000,867000,0
295584,1,82,663000,667000,4000
295584,2,99,667000,686000,19000
295584,3,73,686000,694000,8000
295584,4,96,694000,709000,15000
295584,5,64,709000,704000,-5000
295584,6,61,704000,685000,-19000
295584,7,76,685000,668000,-17000
295584,8,89,668000,665000,-3000
295584,9,52,665000,645000,-20000
295584,10,74,645000,633000,-12000
295584,11,78,633000,629000,-4000
295584,12,NA,629000,629000,0
295584,13,65,629000,619000,-10000
295584,14,98,619000,634000,15000
295584,15,94,634000,658000,24000
295584,16,47,658000,652000,-6000
295584,17,NA,652000,652000,0
295584,18,80,652000,648000,-4000
295584,19,21,648000,606000,-42000
295584,20,NA,606000,606000,0
295584,21,64,606000,571000,-35000
295584,22,68,571000,550000,-21000
295584,23,122,550000,580000,30000
295584,24,61,580000,593000,13000
295898,1,79,744000,739000,-5000
295898,2,102,739000,748000,9000
295898,3,104,748000,766000,18000
295898,4,142,766000,816000,50000
295898,5,100,816000,851000,35000
295898,6,97,851000,871000,20000
295898,7,108,871000,884000,13000
295898,8,96,884000,883000,-1000
295898,9,101,883000,876000,-7000
295898,10,96,876000,866000,-10000
295898,11,89,866000,851000,-15000
295898,12,112,851000,849000,-2000
295898,13,99,849000,848000,-1000
295898,14,NA,848000,848000,0
295898,15,107,848000,854000,6000
295898,16,NA,854000,854000,0
295898,17,108,854000,864000,10000
295898,18,88,864000,859000,-5000
295898,19,67,859000,830000,-29000
295898,20,83,830000,801000,-29000
295898,21,112,801000,795000,-6000
295898,22,71,795000,775000,-20000
295898,23,100,775000,770000,-5000
295898,24,111,770000,781000,11000
296035,1,NA,585000,585000,0
296035,2,NA,585000,585000,0
296035,3,NA,585000,585000,0
296035,4,NA,585000,585000,0
296035,5,NA,585000,585000,0
296035,6,NA,585000,585000,0
296035,7,NA,585000,585000,0
296035,8,NA,585000,585000,0
296035,9,NA,585000,585000,0
296035,10,NA,585000,585000,0
296035,11,NA,585000,585000,0
296035,12,NA,585000,585000,0
296035,13,NA,585000,585000,0
296035,14,NA,585000,585000,0
296035,15,NA,585000,585000,0
296035,16,NA,585000,585000,0
296035,17,NA,585000,585000,0
296035,18,NA,585000,585000,0
296035,19,NA,585000,585000,0
296035,20,NA,585000,585000,0
296035,21,NA,585000,585000,0
296035,22,NA,585000,585000,0
296035,23,NA,585000,585000,0
296035,24,NA,585000,585000,0
296041,1,NA,459000,459000,0
296041,2,NA,459000,459000,0
296041,3,NA,459000,459000,0
296041,4,NA,459000,459000,0
296041,5,67,459000,468000,9000
296041,6,40,468000,464000,-4000
296041,7,66,464000,470000,6000
296041,8,NA,470000,470000,0
296041,9,NA,470000,470000,0
296041,10,45,470000,465000,-5000
296041,11,71,465000,473000,8000
296041,12,59,473000,479000,6000
296041,13,NA,479000,479000,0
296041,14,21,479000,461000,-18000
296041,15,NA,461000,461000,0
296041,16,NA,461000,461000,0
296041,17,NA,461000,461000,0
296041,18,NA,461000,461000,0
296041,19,NA,461000,461000,0
296041,20,NA,461000,461000,0
296041,21,NA,461000,461000,0
296041,22,NA,461000,461000,0
296041,23,NA,461000,461000,0
296041,24,NA,461000,461000,0
296190,1,32,452000,437000,-15000
296190,2,NA,437000,437000,0
296190,3,NA,437000,437000,0
296190,4,NA,437000,437000,0
296190,5,NA,437000,437000,0
296190,6,NA,437000,437000,0
296190,7,NA,437000,437000,0
296190,8,NA,437000,437000,0
296190,9,NA,437000,437000,0
296190,10,NA,437000,437000,0
296190,11,NA,437000,437000,0
296190,12,NA,437000,437000,0
296190,13,42,437000,418000,-19000
296190,14,25,418000,391000,-27000
296190,15,NA,391000,391000,0
296190,16,86,391000,402000,11000
296190,17,44,402000,408000,6000
296190,18,50,408000,415000,7000
296190,19,NA,415000,415000,0
296190,20,65,415000,432000,17000
296190,21,69,432000,455000,23000
296190,22,69,455000,476000,21000
296190,23,87,476000,511000,35000
296190,24,26,511000,505000,-6000
296205,1,102,978000,970000,-8000
296205,2,118,970000,969000,-1000
296205,3,NA,969000,969000,0
296205,4,NA,969000,969000,0
296205,5,NA,969000,969000,0
296205,6,78,969000,942000,-27000
296205,7,128,942000,937000,-5000
296205,8,85,937000,918000,-19000
296205,9,75,918000,883000,-35000
296205,10,121,883000,873000,-10000
296205,11,78,873000,851000,-22000
296205,12,NA,851000,851000,0
296205,13,88,851000,827000,-24000
296205,14,60,827000,794000,-33000
296205,15,104,794000,780000,-14000
296205,16,87,780000,768000,-12000
296205,17,146,768000,802000,34000
296205,18,106,802000,833000,31000
296205,19,133,833000,878000,45000
296205,20,116,878000,913000,35000
296205,21,59,913000,898000,-15000
296205,22,91,898000,871000,-27000
296205,23,115,871000,861000,-10000
296205,24,67,861000,825000,-36000
296225,1,79,502000,518000,16000
296225,2,45,518000,518000,0
296225,3,35,518000,500000,-18000
296225,4,29,500000,465000,-35000
296225,5,30,465000,426000,-39000
296225,6,57,426000,406000,-20000
296225,7,60,406000,406000,0
296225,8,68,406000,424000,18000
296225,9,NA,424000,424000,0
296225,10,NA,424000,424000,0
296225,11,36,424000,428000,4000
296225,12,74,428000,447000,19000
296225,13,38,447000,446000,-1000
296225,14,NA,446000,446000,0
296225,15,NA,446000,446000,0
296225,16,NA,446000,446000,0
296225,17,49,446000,441000,-5000
296225,18,NA,441000,441000,0
296225,19,68,441000,448000,7000
296225,20,NA,448000,448000,0
296225,21,75,448000,469000,21000
296225,22,71,469000,491000,22000
296225,23,52,491000,502000,11000
296225,24,65,502000,510000,8000
296254,1,75,548000,557000,9000
296254,2,73,557000,570000,13000
296254,3,69,570000,580000,10000
296254,4,89,580000,601000,21000
296254,5,54,601000,602000,1000
296254,6,82,602000,610000,8000
296254,7,90,610000,627000,17000
296254,8,58,627000,626000,-1000
296254,9,63,626000,616000,-10000
296254,10,54,616000,597000,-19000
296254,11,97,597000,602000,5000
296254,12,118,602000,638000,36000
296254,13,124,638000,697000,59000
296254,14,NA,697000,697000,0
296254,15,108,697000,755000,58000
296254,16,NA,755000,755000,0
296254,17,23,755000,743000,-12000
296254,18,100,743000,738000,-5000
296254,19,73,738000,718000,-20000
296254,20,122,718000,729000,11000
296254,21,73,729000,729000,0
296254,22,65,729000,719000,-10000
296254,23,68,719000,698000,-21000
296254,24,96,698000,691000,-7000
296269,1,NA,442000,442000,0
296269,2,NA,442000,442000,0
296269,3,NA,442000,442000,0
296269,4,NA,442000,442000,0
296269,5,NA,442000,442000,0
296269,6,NA,442000,442000,0
296269,7,NA,442000,442000,0
296269,8,NA,442000,442000,0
296269,9,NA,442000,442000,0
296269,10,NA,442000,442000,0
296269,11,38,442000,431000,-11000
296269,12,NA,431000,431000,0
296269,13,41,431000,416000,-15000
296269,14,NA,416000,416000,0
296269,15,NA,416000,416000,0
296269,16,NA,416000,416000,0
296269,17,NA,416000,416000,0
296269,18,NA,416000,416000,0
296269,19,NA,416000,416000,0
296269,20,NA,416000,416000,0
296269,21,NA,416000,416000,0
296269,22,NA,416000,416000,0
296269,23,NA,416000,416000,0
296269,24,NA,416000,416000,0
296280,1,NA,200000,200000,0
296280,2,NA,200000,200000,0
296280,3,NA,200000,200000,0
296280,4,NA,200000,200000,0
296280,5,NA,200000,200000,0
296280,6,NA,200000,200000,0
296280,7,NA,200000,200000,0
296280,8,6,200000,200000,0
296280,9,29,200000,200000,0
296280,10,NA,200000,200000,0
296280,11,NA,200000,200000,0
296280,12,NA,200000,200000,0
296280,13,NA,200000,200000,0
296280,14,NA,200000,200000,0
296280,15,NA,200000,200000,0
296280,16,NA,200000,200000,0
296280,17,NA,200000,200000,0
296280,18,NA,200000,200000,0
296280,19,NA,200000,200000,0
296280,20,NA,200000,200000,0
296280,21,22,200000,200000,0
296280,22,46,200000,200000,0
296280,23,NA,200000,200000,0
296280,24,NA,200000,200000,0
296291,1,NA,421000,421000,0
296291,2,NA,421000,421000,0
296291,3,NA,421000,421000,0
296291,4,47,421000,418000,-3000
296291,5,51,418000,418000,0
296291,6,68,418000,433000,15000
296291,7,41,433000,435000,2000
296291,8,77,435000,455000,20000
296291,9,39,455000,456000,1000
296291,10,47,456000,451000,-5000
296291,11,56,451000,448000,-3000
296291,12,59,448000,451000,3000
296291,13,NA,451000,451000,0
296291,14,53,451000,453000,2000
296291,15,51,453000,454000,1000
296291,16,51,454000,453000,-1000
296291,17,NA,453000,453000,0
296291,18,43,453000,443000,-10000
296291,19,58,443000,441000,-2000
296291,20,42,441000,432000,-9000
296291,21,35,432000,416000,-16000
296291,22,21,416000,386000,-30000
296291,23,39,386000,363000,-23000
296291,24,59,363000,359000,-4000
296294,1,61,755000,736000,-19000
296294,2,107,736000,738000,2000
296294,3,73,738000,731000,-7000
296294,4,NA,731000,731000,0
296294,5,89,731000,730000,-1000
296294,6,126,730000,760000,30000
296294,7,129,760000,808000,48000
296294,8,103,808000,843000,35000
296294,9,57,843000,834000,-9000
296294,10,74,834000,807000,-27000
296294,11,75,807000,771000,-36000
296294,12,80,771000,738000,-33000
296294,13,76,738000,712000,-26000
296294,14,82,712000,703000,-9000
296294,15,NA,703000,703000,0
296294,16,113,703000,720000,17000
296294,17,77,720000,726000,6000
296294,18,89,726000,732000,6000
296294,19,78,732000,729000,-3000
296294,20,73,729000,717000,-12000
296294,21,117,717000,730000,13000
296294,22,95,730000,745000,15000
296294,23,82,745000,750000,5000
296294,24,75,750000,741000,-9000
296296,1,79,591000,599000,8000
296296,2,72,599000,607000,8000
296296,3,72,607000,613000,6000
296296,4,NA,613000,613000,0
296296,5,NA,613000,613000,0
296296,6,NA,613000,613000,0
296296,7,NA,613000,613000,0
296296,8,111,613000,644000,31000
296296,9,81,644000,666000,22000
296296,10,139,666000,721000,55000
296296,11,64,721000,740000,19000
296296,12,138,740000,785000,45000
296296,13,52,785000,780000,-5000
296296,14,NA,780000,780000,0
296296,15,67,780000,759000,-21000
296296,16,107,759000,754000,-5000
296296,17,75,754000,741000,-13000
296296,18,95,741000,736000,-5000
296296,19,77,736000,731000,-5000
296296,20,115,731000,749000,18000
296296,21,NA,749000,749000,0
296296,22,NA,749000,749000,0
296296,23,NA,749000,749000,0
296296,24,NA,749000,749000,0
296324,1,67,675000,667000,-8000
296324,2,102,667000,680000,13000
296324,3,55,680000,671000,-9000
296324,4,61,671000,652000,-19000
296324,5,87,652000,649000,-3000
296324,6,63,649000,639000,-10000
296324,7,49,639000,612000,-27000
296324,8,101,612000,619000,7000
296324,9,56,619000,612000,-7000
296324,10,72,612000,607000,-5000
296324,11,112,607000,634000,27000
296324,12,46,634000,631000,-3000
296324,13,99,631000,644000,13000
296324,14,NA,644000,644000,0
296324,15,NA,644000,644000,0
296324,16,37,644000,627000,-17000
296324,17,86,627000,623000,-4000
296324,18,47,623000,598000,-25000
296324,19,NA,598000,598000,0
296324,20,NA,598000,598000,0
296324,21,55,598000,574000,-24000
296324,22,50,574000,546000,-28000
296324,23,188,546000,617000,71000
296324,24,44,617000,640000,23000
296334,1,44,400000,398000,-2000
296334,2,44,398000,396000,-2000
296334,3,25,396000,379000,-17000
296334,4,NA,379000,379000,0
296334,5,NA,379000,379000,0
296334,6,NA,379000,379000,0
296334,7,NA,379000,379000,0
296334,8,NA,379000,379000,0
296334,9,NA,379000,379000,0
296334,10,NA,379000,379000,0
296334,11,NA,379000,379000,0
296334,12,NA,379000,379000,0
296334,13,NA,379000,379000,0
296334,14,NA,379000,379000,0
296334,15,NA,379000,379000,0
296334,16,NA,379000,379000,0
296334,17,NA,379000,379000,0
296334,18,NA,379000,379000,0
296334,19,NA,379000,379000,0
296334,20,NA,379000,379000,0
296334,21,NA,379000,379000,0
296334,22,NA,379000,379000,0
296334,23,NA,379000,379000,0
296334,24,NA,379000,379000,0
296347,1,91,899000,890000,-9000
296347,2,NA,890000,890000,0
296347,3,126,890000,899000,9000
296347,4,106,899000,905000,6000
296347,5,79,905000,892000,-13000
296347,6,125,892000,899000,7000
296347,7,104,899000,902000,3000
296347,8,109,902000,904000,2000
296347,9,113,904000,911000,7000
296347,10,97,911000,908000,-3000
296347,11,NA,908000,908000,0
296347,12,NA,908000,908000,0
296347,13,NA,908000,908000,0
296347,14,120,908000,918000,10000
296347,15,NA,918000,918000,0
296347,16,96,918000,914000,-4000
296347,17,30,914000,855000,-59000
296347,18,108,855000,822000,-33000
296347,19,94,822000,800000,-22000
296347,20,122,800000,806000,6000
296347,21,71,806000,797000,-9000
296347,22,73,797000,782000,-15000
296347,23,85,782000,764000,-18000
296347,24,111,764000,763000,-1000
296351,1,NA,693000,693000,0
296351,2,NA,693000,693000,0
296351,3,NA,693000,693000,0
296351,4,NA,693000,693000,0
296351,5,NA,693000,693000,0
296351,6,NA,693000,693000,0
296351,7,NA,693000,693000,0
296351,8,NA,693000,693000,0
296351,9,NA,693000,693000,0
296351,10,NA,693000,693000,0
296351,11,NA,693000,693000,0
296351,12,NA,693000,693000,0
296351,13,NA,693000,693000,0
296351,14,NA,693000,693000,0
296351,15,NA,693000,693000,0
296351,16,NA,693000,693000,0
296351,17,75,693000,687000,-6000
296351,18,NA,687000,687000,0
296351,19,48,687000,660000,-27000
296351,20,59,660000,628000,-32000
296351,21,NA,628000,628000,0
296351,22,NA,628000,628000,0
296351,23,NA,628000,628000,0
296351,24,NA,628000,628000,0
296355,1,88,688000,694000,6000
296355,2,62,694000,686000,-8000
296355,3,87,686000,685000,-1000
296355,4,81,685000,685000,0
296355,5,66,685000,675000,-10000
296355,6,72,675000,665000,-10000
296355,7,104,665000,678000,13000
296355,8,78,678000,684000,6000
296355,9,85,684000,692000,8000
296355,10,76,692000,693000,1000
296355,11,81,693000,692000,-1000
296355,12,93,692000,697000,5000
296355,13,59,697000,683000,-14000
296355,14,73,683000,673000,-10000
296355,15,NA,673000,673000,0
296355,16,85,673000,670000,-3000
296355,17,111,670000,690000,20000
296355,18,84,690000,704000,14000
296355,19,87,704000,717000,13000
296355,20,31,717000,687000,-30000
296355,21,86,687000,669000,-18000
296355,22,50,669000,634000,-35000
296355,23,15,634000,571000,-63000
296355,24,NA,571000,571000,0
296359,1,NA,653000,653000,0
296359,2,NA,653000,653000,0
296359,3,NA,653000,653000,0
296359,4,NA,653000,653000,0
296359,5,NA,653000,653000,0
296359,6,NA,653000,653000,0
296359,7,NA,653000,653000,0
296359,8,NA,653000,653000,0
296359,9,NA,653000,653000,0
296359,10,73,653000,648000,-5000
296359,11,78,648000,646000,-2000
296359,12,75,646000,644000,-2000
296359,13,100,644000,659000,15000
296359,14,NA,659000,659000,0
296359,15,75,659000,669000,10000
296359,16,98,669000,689000,20000
296359,17,99,689000,713000,24000
296359,18,52,713000,703000,-10000
296359,19,86,703000,697000,-6000
296359,20,53,697000,672000,-25000
296359,21,84,672000,658000,-14000
296359,22,88,658000,656000,-2000
296359,23,85,656000,663000,7000
296359,24,39,663000,637000,-26000
296420,1,79,599000,606000,7000
296420,2,78,606000,618000,12000
296420,3,67,618000,622000,4000
296420,4,87,622000,633000,11000
296420,5,77,633000,643000,10000
296420,6,63,643000,640000,-3000
296420,7,81,640000,641000,1000
296420,8,56,641000,628000,-13000
296420,9,92,628000,631000,3000
296420,10,46,631000,613000,-18000
296420,11,84,613000,611000,-2000
296420,12,66,611000,605000,-6000
296420,13,81,605000,608000,3000
296420,14,NA,608000,608000,0
296420,15,62,608000,605000,-3000
296420,16,65,605000,600000,-5000
296420,17,58,600000,586000,-14000
296420,18,67,586000,576000,-10000
296420,19,55,576000,559000,-17000
296420,20,98,559000,573000,14000
296420,21,90,573000,599000,26000
296420,22,65,599000,611000,12000
296420,23,58,611000,608000,-3000
296420,24,97,608000,620000,12000
296422,1,71,605000,606000,1000
296422,2,78,606000,613000,7000
296422,3,100,613000,638000,25000
296422,4,106,638000,677000,39000
296422,5,117,677000,728000,51000
296422,6,35,728000,724000,-4000
296422,7,91,724000,723000,-1000
296422,8,101,723000,729000,6000
296422,9,59,729000,711000,-18000
296422,10,88,711000,702000,-9000
296422,11,75,702000,695000,-7000
296422,12,NA,695000,695000,0
296422,13,96,695000,698000,3000
296422,14,81,698000,703000,5000
296422,15,73,703000,700000,-3000
296422,16,79,700000,695000,-5000
296422,17,90,695000,697000,2000
296422,18,97,697000,707000,10000
296422,19,88,707000,717000,10000
296422,20,99,717000,734000,17000
296422,21,107,734000,759000,25000
296422,22,86,759000,769000,10000
296422,23,97,769000,778000,9000
296422,24,91,778000,779000,1000
296588,1,NA,450000,450000,0
296588,2,7,450000,416000,-34000
296588,3,12,416000,365000,-51000
296588,4,35,365000,326000,-39000
296588,5,NA,326000,326000,0
296588,6,NA,326000,326000,0
296588,7,NA,326000,326000,0
296588,8,NA,326000,326000,0
296588,9,NA,326000,326000,0
296588,10,NA,326000,326000,0
296588,11,NA,326000,326000,0
296588,12,NA,326000,326000,0
296588,13,NA,326000,326000,0
296588,14,NA,326000,326000,0
296588,15,NA,326000,326000,0
296588,16,NA,326000,326000,0
296588,17,NA,326000,326000,0
296588,18,NA,326000,326000,0
296588,19,NA,326000,326000,0
296588,20,NA,326000,326000,0
296588,21,NA,326000,326000,0
296588,22,NA,326000,326000,0
296588,23,NA,326000,326000,0
296588,24,NA,326000,326000,0
296733,1,58,800000,775000,-25000
296733,2,75,775000,746000,-29000
296733,3,90,746000,730000,-16000
296733,4,38,730000,686000,-44000
296733,5,111,686000,685000,-1000
296733,6,73,685000,683000,-2000
296733,7,89,683000,688000,5000
296733,8,79,688000,691000,3000
296733,9,73,691000,689000,-2000
296733,10,86,689000,688000,-1000
296733,11,95,688000,697000,9000
296733,12,107,697000,719000,22000
296733,13,NA,719000,719000,0
296733,14,80,719000,734000,15000
296733,15,91,734000,746000,12000
296733,16,83,746000,748000,2000
296733,17,105,748000,758000,10000
296733,18,81,758000,757000,-1000
296733,19,90,757000,757000,0
296733,20,44,757000,724000,-33000
296733,21,NA,724000,724000,0
296733,22,NA,724000,724000,0
296733,23,NA,724000,724000,0
296733,24,NA,724000,724000,0
296735,1,NA,797000,797000,0
296735,2,NA,797000,797000,0
296735,3,NA,797000,797000,0
296735,4,NA,797000,797000,0
296735,5,NA,797000,797000,0
296735,6,83,797000,789000,-8000
296735,7,136,789000,814000,25000
296735,8,NA,814000,814000,0
296735,9,NA,814000,814000,0
296735,10,74,814000,814000,0
296735,11,59,814000,788000,-26000
296735,12,96,788000,772000,-16000
296735,13,105,772000,771000,-1000
296735,14,NA,771000,771000,0
296735,15,NA,771000,771000,0
296735,16,NA,771000,771000,0
296735,17,NA,771000,771000,0
296735,18,NA,771000,771000,0
296735,19,NA,771000,771000,0
296735,20,NA,771000,771000,0
296735,21,NA,771000,771000,0
296735,22,NA,771000,771000,0
296735,23,NA,771000,771000,0
296735,24,NA,771000,771000,0
297255,1,93,540000,563000,23000
297255,2,62,563000,577000,14000
297255,3,69,577000,588000,11000
297255,4,93,588000,610000,22000
297255,5,NA,610000,610000,0
297255,6,73,610000,624000,14000
297255,7,35,624000,603000,-21000
297255,8,84,603000,599000,-4000
297255,9,58,599000,587000,-12000
297255,10,30,587000,549000,-38000
297255,11,95,549000,549000,0
297255,12,87,549000,567000,18000
297255,13,54,567000,568000,1000
297255,14,70,568000,577000,9000
297255,15,NA,577000,577000,0
297255,16,96,577000,602000,25000
297255,17,54,602000,601000,-1000
297255,18,80,601000,605000,4000
297255,19,57,605000,599000,-6000
297255,20,70,599000,593000,-6000
297255,21,NA,593000,593000,0
297255,22,NA,593000,593000,0
297255,23,NA,593000,593000,0
297255,24,84,593000,594000,1000
297354,1,74,855000,837000,-18000
297354,2,71,837000,805000,-32000
297354,3,85,805000,778000,-27000
297354,4,73,778000,748000,-30000
297354,5,82,748000,729000,-19000
297354,6,97,729000,730000,1000
297354,7,57,730000,711000,-19000
297354,8,87,711000,703000,-8000
297354,9,68,703000,688000,-15000
297354,10,90,688000,684000,-4000
297354,11,68,684000,673000,-11000
297354,12,90,673000,675000,2000
297354,13,64,675000,665000,-10000
297354,14,NA,665000,665000,0
297354,15,67,665000,653000,-12000
297354,16,74,653000,643000,-10000
297354,17,105,643000,657000,14000
297354,18,109,657000,688000,31000
297354,19,100,688000,722000,34000
297354,20,NA,722000,722000,0
297354,21,NA,722000,722000,0
297354,22,138,722000,780000,58000
297354,23,121,780000,835000,55000
297354,24,103,835000,864000,29000
297373,1,99,891000,888000,-3000
297373,2,92,888000,879000,-9000
297373,3,94,879000,866000,-13000
297373,4,108,866000,863000,-3000
297373,5,100,863000,862000,-1000
297373,6,148,862000,897000,35000
297373,7,90,897000,909000,12000
297373,8,129,909000,932000,23000
297373,9,118,932000,950000,18000
297373,10,110,950000,958000,8000
297373,11,116,958000,961000,3000
297373,12,108,961000,959000,-2000
297373,13,116,959000,957000,-2000
297373,14,158,957000,994000,37000
297373,15,NA,994000,994000,0
297373,16,116,994000,1014000,20000
297373,17,114,1014000,1022000,8000
297373,18,142,1022000,1040000,18000
297373,19,128,1040000,1053000,13000
297373,20,86,1053000,1030000,-23000
297373,21,151,1030000,1037000,7000
297373,22,102,1037000,1026000,-11000
297373,23,140,1026000,1030000,4000
297373,24,125,1030000,1032000,2000
297401,1,NA,778000,778000,0
297401,2,NA,778000,778000,0
297401,3,NA,778000,778000,0
297401,4,NA,778000,778000,0
297401,5,NA,778000,778000,0
297401,6,NA,778000,778000,0
297401,7,NA,778000,778000,0
297401,8,40,778000,740000,-38000
297401,9,NA,740000,740000,0
297401,10,NA,740000,740000,0
297401,11,NA,740000,740000,0
297401,12,NA,740000,740000,0
297401,13,NA,740000,740000,0
297401,14,NA,740000,740000,0
297401,15,NA,740000,740000,0
297401,16,NA,740000,740000,0
297401,17,NA,740000,740000,0
297401,18,NA,740000,740000,0
297401,19,82,740000,708000,-32000
297401,20,105,708000,703000,-5000
297401,21,120,703000,728000,25000
297401,22,103,728000,759000,31000
297401,23,101,759000,789000,30000
297401,24,74,789000,789000,0
297452,1,NA,684000,684000,0
297452,2,NA,684000,684000,0
297452,3,46,684000,658000,-26000
297452,4,NA,658000,658000,0
297452,5,37,658000,611000,-47000
297452,6,NA,611000,611000,0
297452,7,56,611000,568000,-43000
297452,8,36,568000,522000,-46000
297452,9,72,522000,503000,-19000
297452,10,84,503000,514000,11000
297452,11,73,514000,533000,19000
297452,12,74,533000,553000,20000
297452,13,95,553000,588000,35000
297452,14,NA,588000,588000,0
297452,15,NA,588000,588000,0
297452,16,NA,588000,588000,0
297452,17,NA,588000,588000,0
297452,18,43,588000,588000,0
297452,19,34,588000,560000,-28000
297452,20,87,560000,556000,-4000
297452,21,113,556000,585000,29000
297452,22,90,585000,618000,33000
297452,23,91,618000,654000,36000
297452,24,75,654000,673000,19000
297456,1,69,513000,520000,7000
297456,2,38,520000,509000,-11000
297456,3,80,509000,517000,8000
297456,4,63,517000,523000,6000
297456,5,61,523000,528000,5000
297456,6,46,528000,519000,-9000
297456,7,86,519000,533000,14000
297456,8,NA,533000,533000,0
297456,9,NA,533000,533000,0
297456,10,79,533000,549000,16000
297456,11,90,549000,578000,29000
297456,12,45,578000,580000,2000
297456,13,NA,580000,580000,0
297456,14,59,580000,577000,-3000
297456,15,45,577000,554000,-23000
297456,16,26,554000,510000,-44000
297456,17,59,510000,481000,-29000
297456,18,69,481000,475000,-6000
297456,19,34,475000,457000,-18000
297456,20,46,457000,444000,-13000
297456,21,41,444000,429000,-15000
297456,22,47,429000,416000,-13000
297456,23,NA,416000,416000,0
297456,24,NA,416000,416000,0
297473,1,56,521000,518000,-3000
297473,2,53,518000,511000,-7000
297473,3,109,511000,543000,32000
297473,4,54,543000,556000,13000
297473,5,45,556000,550000,-6000
297473,6,60,550000,544000,-6000
297473,7,41,544000,521000,-23000
297473,8,61,521000,504000,-17000
297473,9,NA,504000,504000,0
297473,10,NA,504000,504000,0
297473,11,NA,504000,504000,0
297473,12,NA,504000,504000,0
297473,13,NA,504000,504000,0
297473,14,NA,504000,504000,0
297473,15,53,504000,491000,-13000
297473,16,59,491000,486000,-5000
297473,17,68,486000,492000,6000
297473,18,59,492000,497000,5000
297473,19,113,497000,538000,41000
297473,20,42,538000,549000,11000
297473,21,45,549000,541000,-8000
297473,22,52,541000,525000,-16000
297473,23,31,525000,491000,-34000
297473,24,NA,491000,491000,0
297504,1,41,544000,528000,-16000
297504,2,53,528000,511000,-17000
297504,3,77,511000,512000,1000
297504,4,56,512000,511000,-1000
297504,5,3,511000,472000,-39000
297504,6,NA,472000,472000,0
297504,7,NA,472000,472000,0
297504,8,NA,472000,472000,0
297504,9,NA,472000,472000,0
297504,10,NA,472000,472000,0
297504,11,NA,472000,472000,0
297504,12,NA,472000,472000,0
297504,13,NA,472000,472000,0
297504,14,NA,472000,472000,0
297504,15,NA,472000,472000,0
297504,16,NA,472000,472000,0
297504,17,NA,472000,472000,0
297504,18,62,472000,452000,-20000
297504,19,53,452000,439000,-13000
297504,20,66,439000,440000,1000
297504,21,58,440000,448000,8000
297504,22,79,448000,475000,27000
297504,23,62,475000,495000,20000
297504,24,35,495000,487000,-8000
297523,1,91,826000,823000,-3000
297523,2,98,823000,823000,0
297523,3,90,823000,819000,-4000
297523,4,65,819000,794000,-25000
297523,5,89,794000,776000,-18000
297523,6,71,776000,752000,-24000
297523,7,92,752000,739000,-13000
297523,8,106,739000,747000,8000
297523,9,76,747000,746000,-1000
297523,10,114,746000,764000,18000
297523,11,104,764000,786000,22000
297523,12,70,786000,781000,-5000
297523,13,94,781000,777000,-4000
297523,14,NA,777000,777000,0
297523,15,77,777000,766000,-11000
297523,16,133,766000,788000,22000
297523,17,101,788000,806000,18000
297523,18,80,806000,809000,3000
297523,19,69,809000,791000,-18000
297523,20,94,791000,779000,-12000
297523,21,75,779000,756000,-23000
297523,22,81,756000,736000,-20000
297523,23,93,736000,730000,-6000
297523,24,71,730000,714000,-16000
297566,1,130,854000,877000,23000
297566,2,87,877000,884000,7000
297566,3,132,884000,909000,25000
297566,4,49,909000,881000,-28000
297566,5,78,881000,845000,-36000
297566,6,115,845000,833000,-12000
297566,7,96,833000,825000,-8000
297566,8,70,825000,801000,-24000
297566,9,103,801000,798000,-3000
297566,10,125,798000,818000,20000
297566,11,165,818000,878000,60000
297566,12,NA,878000,878000,0
297566,13,130,878000,934000,56000
297566,14,NA,934000,934000,0
297566,15,NA,934000,934000,0
297566,16,NA,934000,934000,0
297566,17,NA,934000,934000,0
297566,18,65,934000,938000,4000
297566,19,121,938000,944000,6000
297566,20,95,944000,930000,-14000
297566,21,160,930000,951000,21000
297566,22,84,951000,945000,-6000
297566,23,78,945000,921000,-24000
297566,24,103,921000,896000,-25000
297767,1,NA,213000,213000,0
297767,2,NA,213000,213000,0
297767,3,NA,213000,213000,0
297767,4,NA,213000,213000,0
297767,5,NA,213000,213000,0
297767,6,NA,213000,213000,0
297767,7,NA,213000,213000,0
297767,8,NA,213000,213000,0
297767,9,NA,213000,213000,0
297767,10,NA,213000,213000,0
297767,11,NA,213000,213000,0
297767,12,NA,213000,213000,0
297767,13,NA,213000,213000,0
297767,14,NA,213000,213000,0
297767,15,NA,213000,213000,0
297767,16,NA,213000,213000,0
297767,17,NA,213000,213000,0
297767,18,NA,213000,213000,0
297767,19,NA,213000,213000,0
297767,20,NA,213000,213000,0
297767,21,NA,213000,213000,0
297767,22,NA,213000,213000,0
297767,23,NA,213000,213000,0
297767,24,NA,213000,213000,0
297899,1,61,644000,634000,-10000
297899,2,19,634000,587000,-47000
297899,3,NA,587000,587000,0
297899,4,NA,587000,587000,0
297899,5,NA,587000,587000,0
297899,6,NA,587000,587000,0
297899,7,15,587000,516000,-71000
297899,8,24,516000,446000,-70000
297899,9,NA,446000,446000,0
297899,10,NA,446000,446000,0
297899,11,77,446000,422000,-24000
297899,12,13,422000,386000,-36000
297899,13,NA,386000,386000,0
297899,14,NA,386000,386000,0
297899,15,NA,386000,386000,0
297899,16,68,386000,387000,1000
297899,17,NA,387000,387000,0
297899,18,NA,387000,387000,0
297899,19,NA,387000,387000,0
297899,20,70,387000,408000,21000
297899,21,74,408000,441000,33000
297899,22,NA,441000,441000,0
297899,23,NA,441000,441000,0
297899,24,NA,441000,441000,0
297907,1,61,688000,675000,-13000
297907,2,89,675000,673000,-2000
297907,3,116,673000,700000,27000
297907,4,83,700000,718000,18000
297907,5,77,718000,726000,8000
297907,6,119,726000,756000,30000
297907,7,164,756000,826000,70000
297907,8,76,826000,852000,26000
297907,9,99,852000,867000,15000
297907,10,67,867000,848000,-19000
297907,11,27,848000,779000,-69000
297907,12,NA,779000,779000,0
297907,13,NA,779000,779000,0
297907,14,95,779000,737000,-42000
297907,15,NA,737000,737000,0
297907,16,68,737000,700000,-37000
297907,17,108,700000,697000,-3000
297907,18,108,697000,719000,22000
297907,19,93,719000,743000,24000
297907,20,123,743000,782000,39000
297907,21,139,782000,838000,56000
297907,22,138,838000,897000,59000
297907,23,125,897000,943000,46000
297907,24,82,943000,945000,2000
298111,1,NA,625000,625000,0
298111,2,NA,625000,625000,0
298111,3,30,625000,593000,-32000
298111,4,102,593000,593000,0
298111,5,53,593000,583000,-10000
298111,6,92,583000,596000,13000
298111,7,84,596000,616000,20000
298111,8,83,616000,638000,22000
298111,9,97,638000,664000,26000
298111,10,47,664000,657000,-7000
298111,11,93,657000,661000,4000
298111,12,126,661000,696000,35000
298111,13,49,696000,693000,-3000
298111,14,87,693000,698000,5000
298111,15,NA,698000,698000,0
298111,16,57,698000,683000,-15000
298111,17,79,683000,669000,-14000
298111,18,37,669000,627000,-42000
298111,19,82,627000,610000,-17000
298111,20,47,610000,583000,-27000
298111,21,NA,583000,583000,0
298111,22,81,583000,576000,-7000
298111,23,68,576000,573000,-3000
298111,24,58,573000,565000,-8000
298174,1,116,758000,779000,21000
298174,2,102,779000,804000,25000
298174,3,120,804000,839000,35000
298174,4,105,839000,864000,25000
298174,5,NA,864000,864000,0
298174,6,NA,864000,864000,0
298174,7,NA,864000,864000,0
298174,8,NA,864000,864000,0
298174,9,NA,864000,864000,0
298174,10,94,864000,870000,6000
298174,11,107,870000,873000,3000
298174,12,100,873000,871000,-2000
298174,13,129,871000,886000,15000
298174,14,87,886000,889000,3000
298174,15,NA,889000,889000,0
298174,16,87,889000,876000,-13000
298174,17,113,876000,874000,-2000
298174,18,NA,874000,874000,0
298174,19,NA,874000,874000,0
298174,20,NA,874000,874000,0
298174,21,70,874000,847000,-27000
298174,22,109,847000,835000,-12000
298174,23,109,835000,837000,2000
298174,24,86,837000,827000,-10000
298210,1,109,908000,911000,3000
298210,2,90,911000,903000,-8000
298210,3,99,903000,892000,-11000
298210,4,124,892000,899000,7000
298210,5,104,899000,904000,5000
298210,6,106,904000,909000,5000
298210,7,142,909000,938000,29000
298210,8,80,938000,934000,-4000
298210,9,103,934000,924000,-10000
298210,10,85,924000,899000,-25000
298210,11,116,899000,890000,-9000
298210,12,118,890000,892000,2000
298210,13,103,892000,894000,2000
298210,14,NA,894000,894000,0
298210,15,125,894000,913000,19000
298210,16,117,913000,933000,20000
298210,17,104,933000,938000,5000
298210,18,115,938000,942000,4000
298210,19,102,942000,937000,-5000
298210,20,118,937000,938000,1000
298210,21,108,938000,936000,-2000
298210,22,96,936000,924000,-12000
298210,23,75,924000,892000,-32000
298210,24,100,892000,864000,-28000
298211,1,NA,503000,503000,0
298211,2,49,503000,496000,-7000
298211,3,48,496000,484000,-12000
298211,4,NA,484000,484000,0
298211,5,73,484000,488000,4000
298211,6,NA,488000,488000,0
298211,7,NA,488000,488000,0
298211,8,NA,488000,488000,0
298211,9,NA,488000,488000,0
298211,10,NA,488000,488000,0
298211,11,NA,488000,488000,0
298211,12,NA,488000,488000,0
298211,13,NA,488000,488000,0
298211,14,43,488000,482000,-6000
298211,15,5,482000,441000,-41000
298211,16,20,441000,394000,-47000
298211,17,NA,394000,394000,0
298211,18,NA,394000,394000,0
298211,19,NA,394000,394000,0
298211,20,NA,394000,394000,0
298211,21,79,394000,386000,-8000
298211,22,NA,386000,386000,0
298211,23,NA,386000,386000,0
298211,24,NA,386000,386000,0
298264,1,57,663000,649000,-14000
298264,2,62,649000,629000,-20000
298264,3,81,629000,622000,-7000
298264,4,87,622000,628000,6000
298264,5,92,628000,648000,20000
298264,6,85,648000,670000,22000
298264,7,72,670000,678000,8000
298264,8,40,678000,653000,-25000
298264,9,82,653000,638000,-15000
298264,10,38,638000,600000,-38000
298264,11,56,600000,567000,-33000
298264,12,85,567000,561000,-6000
298264,13,43,561000,544000,-17000
298264,14,NA,544000,544000,0
298264,15,84,544000,549000,5000
298264,16,89,549000,574000,25000
298264,17,80,574000,597000,23000
298264,18,52,597000,596000,-1000
298264,19,92,596000,612000,16000
298264,20,108,612000,644000,32000
298264,21,55,644000,647000,3000
298264,22,87,647000,656000,9000
298264,23,68,656000,654000,-2000
298264,24,71,654000,643000,-11000
298265,1,NA,582000,582000,0
298265,2,NA,582000,582000,0
298265,3,NA,582000,582000,0
298265,4,NA,582000,582000,0
298265,5,NA,582000,582000,0
298265,6,NA,582000,582000,0
298265,7,NA,582000,582000,0
298265,8,NA,582000,582000,0
298265,9,NA,582000,582000,0
298265,10,NA,582000,582000,0
298265,11,NA,582000,582000,0
298265,12,NA,582000,582000,0
298265,13,NA,582000,582000,0
298265,14,NA,582000,582000,0
298265,15,NA,582000,582000,0
298265,16,NA,582000,582000,0
298265,17,NA,582000,582000,0
298265,18,NA,582000,582000,0
298265,19,NA,582000,582000,0
298265,20,NA,582000,582000,0
298265,21,NA,582000,582000,0
298265,22,NA,582000,582000,0
298265,23,NA,582000,582000,0
298265,24,NA,582000,582000,0
298268,1,74,740000,732000,-8000
298268,2,67,732000,713000,-19000
298268,3,77,713000,696000,-17000
298268,4,86,696000,689000,-7000
298268,5,103,689000,703000,14000
298268,6,81,703000,714000,11000
298268,7,96,714000,730000,16000
298268,8,101,730000,750000,20000
298268,9,113,750000,779000,29000
298268,10,63,779000,773000,-6000
298268,11,140,773000,804000,31000
298268,12,137,804000,851000,47000
298268,13,NA,851000,851000,0
298268,14,NA,851000,851000,0
298268,15,69,851000,858000,7000
298268,16,113,858000,871000,13000
298268,17,116,871000,886000,15000
298268,18,84,886000,876000,-10000
298268,19,99,876000,864000,-12000
298268,20,83,864000,846000,-18000
298268,21,96,846000,830000,-16000
298268,22,95,830000,818000,-12000
298268,23,112,818000,822000,4000
298268,24,113,822000,834000,12000
298272,1,108,972000,969000,-3000
298272,2,102,969000,960000,-9000
298272,3,88,960000,936000,-24000
298272,4,120,936000,929000,-7000
298272,5,104,929000,922000,-7000
298272,6,48,922000,877000,-45000
298272,7,NA,877000,877000,0
298272,8,NA,877000,877000,0
298272,9,NA,877000,877000,0
298272,10,NA,877000,877000,0
298272,11,NA,877000,877000,0
298272,12,NA,877000,877000,0
298272,13,NA,877000,877000,0
298272,14,NA,877000,877000,0
298272,15,NA,877000,877000,0
298272,16,NA,877000,877000,0
298272,17,97,877000,844000,-33000
298272,18,108,844000,830000,-14000
298272,19,81,830000,809000,-21000
298272,20,97,809000,800000,-9000
298272,21,NA,800000,800000,0
298272,22,79,800000,788000,-12000
298272,23,118,788000,796000,8000
298272,24,100,796000,802000,6000
298279,1,98,878000,876000,-2000
298279,2,86,876000,863000,-13000
298279,3,74,863000,835000,-28000
298279,4,66,835000,794000,-41000
298279,5,45,794000,736000,-58000
298279,6,80,736000,697000,-39000
298279,7,95,697000,684000,-13000
298279,8,73,684000,676000,-8000
298279,9,81,676000,675000,-1000
298279,10,57,675000,661000,-14000
298279,11,92,661000,661000,0
298279,12,89,661000,667000,6000
298279,13,80,667000,672000,5000
298279,14,NA,672000,672000,0
298279,15,85,672000,682000,10000
298279,16,90,682000,696000,14000
298279,17,105,696000,718000,22000
298279,18,84,718000,730000,12000
298279,19,108,730000,753000,23000
298279,20,77,753000,757000,4000
298279,21,104,757000,768000,11000
298279,22,122,768000,795000,27000
298279,23,86,795000,805000,10000
298279,24,86,805000,800000,-5000
298280,1,94,539000,562000,23000
298280,2,58,562000,575000,13000
298280,3,69,575000,584000,9000
298280,4,48,584000,573000,-11000
298280,5,92,573000,583000,10000
298280,6,33,583000,563000,-20000
298280,7,NA,563000,563000,0
298280,8,NA,563000,563000,0
298280,9,NA,563000,563000,0
298280,10,NA,563000,563000,0
298280,11,72,563000,553000,-10000
298280,12,49,553000,536000,-17000
298280,13,47,536000,515000,-21000
298280,14,NA,515000,515000,0
298280,15,48,515000,493000,-22000
298280,16,75,493000,494000,1000
298280,17,69,494000,502000,8000
298280,18,57,502000,508000,6000
298280,19,138,508000,567000,59000
298280,20,40,567000,585000,18000
298280,21,62,585000,589000,4000
298280,22,80,589000,596000,7000
298280,23,26,596000,567000,-29000
298280,24,124,567000,581000,14000
298281,1,87,452000,478000,26000
298281,2,80,478000,515000,37000
298281,3,45,515000,528000,13000
298281,4,62,528000,534000,6000
298281,5,NA,534000,534000,0
298281,6,78,534000,547000,13000
298281,7,42,547000,536000,-11000
298281,8,29,536000,503000,-33000
298281,9,52,503000,479000,-24000
298281,10,37,479000,450000,-29000
298281,11,24,450000,411000,-39000
298281,12,68,411000,403000,-8000
298281,13,32,403000,391000,-12000
298281,14,NA,391000,391000,0
298281,15,46,391000,385000,-6000
298281,16,61,385000,395000,10000
298281,17,82,395000,427000,32000
298281,18,47,427000,442000,15000
298281,19,37,442000,442000,0
298281,20,64,442000,449000,7000
298281,21,46,449000,446000,-3000
298281,22,49,446000,438000,-8000
298281,23,95,438000,465000,27000
298281,24,40,465000,471000,6000
298288,1,59,499000,500000,1000
298288,2,66,500000,507000,7000
298288,3,31,507000,491000,-16000
298288,4,48,491000,474000,-17000
298288,5,71,474000,474000,0
298288,6,67,474000,484000,10000
298288,7,82,484000,508000,24000
298288,8,66,508000,531000,23000
298288,9,78,531000,555000,24000
298288,10,110,555000,599000,44000
298288,11,49,599000,609000,10000
298288,12,57,609000,602000,-7000
298288,13,58,602000,586000,-16000
298288,14,NA,586000,586000,0
298288,15,58,586000,567000,-19000
298288,16,76,567000,560000,-7000
298288,17,77,560000,567000,7000
298288,18,85,567000,585000,18000
298288,19,76,585000,602000,17000
298288,20,51,602000,598000,-4000
298288,21,55,598000,583000,-15000
298288,22,12,583000,531000,-52000
298288,23,NA,531000,531000,0
298288,24,NA,531000,531000,0
298289,1,NA,610000,610000,0
298289,2,NA,610000,610000,0
298289,3,NA,610000,610000,0
298289,4,NA,610000,610000,0
298289,5,NA,610000,610000,0
298289,6,NA,610000,610000,0
298289,7,NA,610000,610000,0
298289,8,NA,610000,610000,0
298289,9,NA,610000,610000,0
298289,10,NA,610000,610000,0
298289,11,NA,610000,610000,0
298289,12,NA,610000,610000,0
298289,13,78,610000,613000,3000
298289,14,NA,613000,613000,0
298289,15,48,613000,599000,-14000
298289,16,27,599000,559000,-40000
298289,17,95,559000,553000,-6000
298289,18,50,553000,539000,-14000
298289,19,75,539000,540000,1000
298289,20,70,540000,548000,8000
298289,21,61,548000,552000,4000
298289,22,65,552000,551000,-1000
298289,23,11,551000,513000,-38000
298289,24,NA,513000,513000,0
298290,1,NA,583000,583000,0
298290,2,53,583000,572000,-11000
298290,3,53,572000,554000,-18000
298290,4,72,554000,547000,-7000
298290,5,8,547000,504000,-43000
298290,6,66,504000,484000,-20000
298290,7,91,484000,497000,13000
298290,8,87,497000,527000,30000
298290,9,77,527000,558000,31000
298290,10,70,558000,584000,26000
298290,11,73,584000,599000,15000
298290,12,NA,599000,599000,0
298290,13,NA,599000,599000,0
298290,14,27,599000,576000,-23000
298290,15,NA,576000,576000,0
298290,16,NA,576000,576000,0
298290,17,NA,576000,576000,0
298290,18,NA,576000,576000,0
298290,19,NA,576000,576000,0
298290,20,50,576000,543000,-33000
298290,21,61,543000,520000,-23000
298290,22,41,520000,492000,-28000
298290,23,51,492000,471000,-21000
298290,24,NA,471000,471000,0
298302,1,NA,298000,298000,0
298302,2,NA,298000,298000,0
298302,3,NA,298000,298000,0
298302,4,NA,298000,298000,0
298302,5,NA,298000,298000,0
298302,6,NA,298000,298000,0
298302,7,NA,298000,298000,0
298302,8,NA,298000,298000,0
298302,9,NA,298000,298000,0
298302,10,NA,298000,298000,0
298302,11,NA,298000,298000,0
298302,12,NA,298000,298000,0
298302,13,NA,298000,298000,0
298302,14,NA,298000,298000,0
298302,15,NA,298000,298000,0
298302,16,NA,298000,298000,0
298302,17,NA,298000,298000,0
298302,18,NA,298000,298000,0
298302,19,NA,298000,298000,0
298302,20,69,298000,321000,23000
298302,21,52,321000,349000,28000
298302,22,46,349000,369000,20000
298302,23,74,369000,402000,33000
298302,24,39,402000,412000,10000
298312,1,68,490000,499000,9000
298312,2,49,499000,499000,0
298312,3,39,499000,484000,-15000
298312,4,4,484000,436000,-48000
298312,5,NA,436000,436000,0
298312,6,NA,436000,436000,0
298312,7,NA,436000,436000,0
298312,8,NA,436000,436000,0
298312,9,NA,436000,436000,0
298312,10,NA,436000,436000,0
298312,11,NA,436000,436000,0
298312,12,NA,436000,436000,0
298312,13,NA,436000,436000,0
298312,14,NA,436000,436000,0
298312,15,NA,436000,436000,0
298312,16,NA,436000,436000,0
298312,17,NA,436000,436000,0
298312,18,NA,436000,436000,0
298312,19,NA,436000,436000,0
298312,20,NA,436000,436000,0
298312,21,NA,436000,436000,0
298312,22,NA,436000,436000,0
298312,23,NA,436000,436000,0
298312,24,NA,436000,436000,0
298336,1,NA,418000,418000,0
298336,2,NA,418000,418000,0
298336,3,NA,418000,418000,0
298336,4,NA,418000,418000,0
298336,5,NA,418000,418000,0
298336,6,NA,418000,418000,0
298336,7,NA,418000,418000,0
298336,8,NA,418000,418000,0
298336,9,NA,418000,418000,0
298336,10,NA,418000,418000,0
298336,11,NA,418000,418000,0
298336,12,NA,418000,418000,0
298336,13,NA,418000,418000,0
298336,14,NA,418000,418000,0
298336,15,NA,418000,418000,0
298336,16,NA,418000,418000,0
298336,17,NA,418000,418000,0
298336,18,NA,418000,418000,0
298336,19,NA,418000,418000,0
298336,20,NA,418000,418000,0
298336,21,NA,418000,418000,0
298336,22,NA,418000,418000,0
298336,23,NA,418000,418000,0
298336,24,NA,418000,418000,0
298358,1,NA,557000,557000,0
298358,2,NA,557000,557000,0
298358,3,NA,557000,557000,0
298358,4,48,557000,542000,-15000
298358,5,58,542000,529000,-13000
298358,6,69,529000,527000,-2000
298358,7,53,527000,519000,-8000
298358,8,33,519000,496000,-23000
298358,9,59,496000,483000,-13000
298358,10,53,483000,471000,-12000
298358,11,44,471000,456000,-15000
298358,12,6,456000,414000,-42000
298358,13,15,414000,365000,-49000
298358,14,NA,365000,365000,0
298358,15,63,365000,350000,-15000
298358,16,67,350000,360000,10000
298358,17,78,360000,395000,35000
298358,18,62,395000,432000,37000
298358,19,17,432000,431000,-1000
298358,20,58,431000,431000,0
298358,21,5,431000,395000,-36000
298358,22,64,395000,382000,-13000
298358,23,54,382000,381000,-1000
298358,24,75,381000,403000,22000
298409,1,75,405000,426000,21000
298409,2,45,426000,438000,12000
298409,3,50,438000,445000,7000
298409,4,38,445000,438000,-7000
298409,5,34,438000,419000,-19000
298409,6,41,419000,401000,-18000
298409,7,59,401000,398000,-3000
298409,8,32,398000,388000,-10000
298409,9,40,388000,379000,-9000
298409,10,65,379000,388000,9000
298409,11,52,388000,399000,11000
298409,12,NA,399000,399000,0
298409,13,52,399000,408000,9000
298409,14,22,408000,399000,-9000
298409,15,15,399000,368000,-31000
298409,16,51,368000,353000,-15000
298409,17,33,353000,336000,-17000
298409,18,48,336000,333000,-3000
298409,19,50,333000,343000,10000
298409,20,76,343000,375000,32000
298409,21,24,375000,380000,5000
298409,22,53,380000,389000,9000
298409,23,33,389000,383000,-6000
298409,24,28,383000,363000,-20000
298419,1,15,681000,634000,-47000
298419,2,NA,634000,634000,0
298419,3,NA,634000,634000,0
298419,4,NA,634000,634000,0
298419,5,47,634000,580000,-54000
298419,6,NA,580000,580000,0
298419,7,NA,580000,580000,0
298419,8,NA,580000,580000,0
298419,9,45,580000,528000,-52000
298419,10,56,528000,493000,-35000
298419,11,78,493000,491000,-2000
298419,12,NA,491000,491000,0
298419,13,NA,491000,491000,0
298419,14,NA,491000,491000,0
298419,15,NA,491000,491000,0
298419,16,NA,491000,491000,0
298419,17,NA,491000,491000,0
298419,18,NA,491000,491000,0
298419,19,NA,491000,491000,0
298419,20,NA,491000,491000,0
298419,21,20,491000,469000,-22000
298419,22,65,469000,463000,-6000
298419,23,55,463000,460000,-3000
298419,24,115,460000,499000,39000
298421,1,74,742000,734000,-8000
298421,2,88,734000,730000,-4000
298421,3,86,730000,729000,-1000
298421,4,66,729000,714000,-15000
298421,5,23,714000,662000,-52000
298421,6,87,662000,638000,-24000
298421,7,101,638000,641000,3000
298421,8,42,641000,621000,-20000
298421,9,NA,621000,621000,0
298421,10,90,621000,623000,2000
298421,11,53,623000,614000,-9000
298421,12,NA,614000,614000,0
298421,13,73,614000,605000,-9000
298421,14,55,605000,590000,-15000
298421,15,49,590000,568000,-22000
298421,16,89,568000,569000,1000
298421,17,95,569000,590000,21000
298421,18,70,590000,605000,15000
298421,19,42,605000,594000,-11000
298421,20,101,594000,609000,15000
298421,21,70,609000,614000,5000
298421,22,106,614000,638000,24000
298421,23,78,638000,656000,18000
298421,24,81,656000,668000,12000
298437,1,NA,430000,430000,0
298437,2,NA,430000,430000,0
298437,3,NA,430000,430000,0
298437,4,NA,430000,430000,0
298437,5,NA,430000,430000,0
298437,6,NA,430000,430000,0
298437,7,NA,430000,430000,0
298437,8,NA,430000,430000,0
298437,9,NA,430000,430000,0
298437,10,14,430000,402000,-28000
298437,11,NA,402000,402000,0
298437,12,NA,402000,402000,0
298437,13,NA,402000,402000,0
298437,14,0,402000,352000,-50000
298437,15,NA,352000,352000,0
298437,16,56,352000,327000,-25000
298437,17,NA,327000,327000,0
298437,18,NA,327000,327000,0
298437,19,108,327000,362000,35000
298437,20,87,362000,419000,57000
298437,21,65,419000,471000,52000
298437,22,49,471000,499000,28000
298437,23,26,499000,486000,-13000
298437,24,53,486000,466000,-20000
298450,1,NA,235000,235000,0
298450,2,NA,235000,235000,0
298450,3,NA,235000,235000,0
298450,4,NA,235000,235000,0
298450,5,NA,235000,235000,0
298450,6,NA,235000,235000,0
298450,7,NA,235000,235000,0
298450,8,NA,235000,235000,0
298450,9,NA,235000,235000,0
298450,10,NA,235000,235000,0
298450,11,NA,235000,235000,0
298450,12,NA,235000,235000,0
298450,13,NA,235000,235000,0
298450,14,NA,235000,235000,0
298450,15,NA,235000,235000,0
298450,16,NA,235000,235000,0
298450,17,NA,235000,235000,0
298450,18,NA,235000,235000,0
298450,19,NA,235000,235000,0
298450,20,NA,235000,235000,0
298450,21,NA,235000,235000,0
298450,22,NA,235000,235000,0
298450,23,NA,235000,235000,0
298450,24,NA,235000,235000,0
298470,1,33,534000,513000,-21000
298470,2,NA,513000,513000,0
298470,3,NA,513000,513000,0
298470,4,NA,513000,513000,0
298470,5,NA,513000,513000,0
298470,6,NA,513000,513000,0
298470,7,NA,513000,513000,0
298470,8,NA,513000,513000,0
298470,9,NA,513000,513000,0
298470,10,NA,513000,513000,0
298470,11,NA,513000,513000,0
298470,12,NA,513000,513000,0
298470,13,NA,513000,513000,0
298470,14,NA,513000,513000,0
298470,15,NA,513000,513000,0
298470,16,NA,513000,513000,0
298470,17,NA,513000,513000,0
298470,18,37,513000,480000,-33000
298470,19,66,480000,465000,-15000
298470,20,60,465000,461000,-4000
298470,21,72,461000,473000,12000
298470,22,73,473000,495000,22000
298470,23,77,495000,523000,28000
298470,24,NA,523000,523000,0
298524,1,NA,677000,677000,0
298524,2,88,677000,683000,6000
298524,3,90,683000,696000,13000
298524,4,109,696000,724000,28000
298524,5,77,724000,737000,13000
298524,6,133,737000,778000,41000
298524,7,67,778000,784000,6000
298524,8,NA,784000,784000,0
298524,9,NA,784000,784000,0
298524,10,NA,784000,784000,0
298524,11,NA,784000,784000,0
298524,12,NA,784000,784000,0
298524,13,NA,784000,784000,0
298524,14,NA,784000,784000,0
298524,15,66,784000,767000,-17000
298524,16,61,767000,733000,-34000
298524,17,63,733000,694000,-39000
298524,18,NA,694000,694000,0
298524,19,NA,694000,694000,0
298524,20,NA,694000,694000,0
298524,21,NA,694000,694000,0
298524,22,NA,694000,694000,0
298524,23,NA,694000,694000,0
298524,24,NA,694000,694000,0
298539,1,64,787000,767000,-20000
298539,2,79,767000,746000,-21000
298539,3,28,746000,689000,-57000
298539,4,82,689000,655000,-34000
298539,5,105,655000,657000,2000
298539,6,96,657000,677000,20000
298539,7,82,677000,693000,16000
298539,8,64,693000,695000,2000
298539,9,86,695000,696000,1000
298539,10,71,696000,684000,-12000
298539,11,91,684000,683000,-1000
298539,12,NA,683000,683000,0
298539,13,74,683000,678000,-5000
298539,14,NA,678000,678000,0
298539,15,129,678000,713000,35000
298539,16,68,713000,724000,11000
298539,17,90,724000,733000,9000
298539,18,79,733000,732000,-1000
298539,19,87,732000,730000,-2000
298539,20,87,730000,726000,-4000
298539,21,51,726000,701000,-25000
298539,22,83,701000,684000,-17000
298539,23,92,684000,682000,-2000
298539,24,72,682000,672000,-10000
298630,1,95,744000,751000,7000
298630,2,97,751000,764000,13000
298630,3,76,764000,763000,-1000
298630,4,63,763000,742000,-21000
298630,5,73,742000,719000,-23000
298630,6,85,719000,705000,-14000
298630,7,38,705000,664000,-41000
298630,8,101,664000,657000,-7000
298630,9,51,657000,637000,-20000
298630,10,65,637000,617000,-20000
298630,11,90,617000,619000,2000
298630,12,91,619000,634000,15000
298630,13,75,634000,643000,9000
298630,14,NA,643000,643000,0
298630,15,38,643000,625000,-18000
298630,16,83,625000,620000,-5000
298630,17,67,620000,609000,-11000
298630,18,41,609000,580000,-29000
298630,19,82,580000,572000,-8000
298630,20,78,572000,578000,6000
298630,21,96,578000,601000,23000
298630,22,66,601000,612000,11000
298630,23,52,612000,606000,-6000
298630,24,76,606000,600000,-6000
990290,1,85,600000,612000,12000
990290,2,17,612000,581000,-31000
990290,3,86,581000,573000,-8000
990290,4,61,573000,564000,-9000
990290,5,56,564000,552000,-12000
990290,6,76,552000,554000,2000
990290,7,14,554000,522000,-32000
990290,8,37,522000,483000,-39000
990290,9,52,483000,455000,-28000
990290,10,NA,455000,455000,0
990290,11,43,455000,431000,-24000
990290,12,NA,431000,431000,0
990290,13,NA,431000,431000,0
990290,14,NA,431000,431000,0
990290,15,44,431000,414000,-17000
990290,16,93,414000,440000,26000
990290,17,41,440000,449000,9000
990290,18,49,449000,452000,3000
990290,19,NA,452000,452000,0
990290,20,NA,452000,452000,0
990290,21,NA,452000,452000,0
990290,22,NA,452000,452000,0
990290,23,NA,452000,452000,0
990290,24,NA,452000,452000,0
990291,1,75,725000,719000,-6000
990291,2,109,719000,733000,14000
990291,3,52,733000,719000,-14000
990291,4,NA,719000,719000,0
990291,5,NA,719000,719000,0
990291,6,NA,719000,719000,0
990291,7,NA,719000,719000,0
990291,8,NA,719000,719000,0
990291,9,NA,719000,719000,0
990291,10,57,719000,688000,-31000
990291,11,79,688000,667000,-21000
990291,12,109,667000,675000,8000
990291,13,96,675000,691000,16000
990291,14,NA,691000,691000,0
990291,15,106,691000,725000,34000
990291,16,58,725000,728000,3000
990291,17,77,728000,721000,-7000
990291,18,NA,721000,721000,0
990291,19,99,721000,721000,0
990291,20,98,721000,729000,8000
990291,21,80,729000,730000,1000
990291,22,75,730000,725000,-5000
990291,23,106,725000,735000,10000
990291,24,68,735000,723000,-12000
990606,1,NA,651000,651000,0
990606,2,NA,651000,651000,0
990606,3,NA,651000,651000,0
990606,4,NA,651000,651000,0
990606,5,90,651000,660000,9000
990606,6,61,660000,656000,-4000
990606,7,26,656000,615000,-41000
990606,8,NA,615000,615000,0
990606,9,NA,615000,615000,0
990606,10,80,615000,594000,-21000
990606,11,74,594000,583000,-11000
990606,12,48,583000,562000,-21000
990606,13,79,562000,561000,-1000
990606,14,NA,561000,561000,0
990606,15,57,561000,559000,-2000
990606,16,51,559000,546000,-13000
990606,17,35,546000,516000,-30000
990606,18,62,516000,499000,-17000
990606,19,36,499000,471000,-28000
990606,20,42,471000,446000,-25000
990606,21,NA,446000,446000,0
990606,22,12,446000,404000,-42000
990606,23,NA,404000,404000,0
990606,24,40,404000,372000,-32000
990609,1,32,613000,585000,-28000
990609,2,65,585000,562000,-23000
990609,3,57,562000,542000,-20000
990609,4,107,542000,562000,20000
990609,5,86,562000,593000,31000
990609,6,108,593000,644000,51000
990609,7,57,644000,660000,16000
990609,8,85,660000,674000,14000
990609,9,36,674000,646000,-28000
990609,10,52,646000,608000,-38000
990609,11,66,608000,579000,-29000
990609,12,NA,579000,579000,0
990609,13,68,579000,563000,-16000
990609,14,37,563000,537000,-26000
990609,15,32,537000,501000,-36000
990609,16,62,501000,483000,-18000
990609,17,28,483000,450000,-33000
990609,18,60,450000,436000,-14000
990609,19,55,436000,433000,-3000
990609,20,83,433000,456000,23000
990609,21,81,456000,490000,34000
990609,22,74,490000,524000,34000
990609,23,63,524000,543000,19000
990609,24,68,543000,554000,11000
990704,1,84,903000,888000,-15000
990704,2,101,888000,876000,-12000
990704,3,111,876000,876000,0
990704,4,94,876000,869000,-7000
990704,5,81,869000,853000,-16000
990704,6,126,853000,864000,11000
990704,7,116,864000,880000,16000
990704,8,70,880000,866000,-14000
990704,9,73,866000,837000,-29000
990704,10,89,837000,812000,-25000
990704,11,68,812000,773000,-39000
990704,12,68,773000,733000,-40000
990704,13,45,733000,683000,-50000
990704,14,110,683000,679000,-4000
990704,15,NA,679000,679000,0
990704,16,91,679000,685000,6000
990704,17,88,685000,696000,11000
990704,18,100,696000,718000,22000
990704,19,NA,718000,718000,0
990704,20,97,718000,741000,23000
990704,21,62,741000,734000,-7000
990704,22,120,734000,750000,16000
990704,23,62,750000,741000,-9000
990704,24,NA,741000,741000,0
990740,1,23,588000,555000,-33000
990740,2,NA,555000,555000,0
990740,3,23,555000,500000,-55000
990740,4,71,500000,473000,-27000
990740,5,44,473000,451000,-22000
990740,6,78,451000,460000,9000
990740,7,46,460000,465000,5000
990740,8,53,465000,468000,3000
990740,9,54,468000,468000,0
990740,10,50,468000,463000,-5000
990740,11,62,463000,463000,0
990740,12,43,463000,456000,-7000
990740,13,57,456000,454000,-2000
990740,14,59,454000,459000,5000
990740,15,NA,459000,459000,0
990740,16,60,459000,466000,7000
990740,17,38,466000,457000,-9000
990740,18,NA,457000,457000,0
990740,19,NA,457000,457000,0
990740,20,61,457000,457000,0
990740,21,74,457000,470000,13000
990740,22,79,470000,494000,24000
990740,23,88,494000,530000,36000
990740,24,106,530000,582000,52000
990816,1,NA,344000,344000,0
990816,2,NA,344000,344000,0
990816,3,NA,344000,344000,0
990816,4,NA,344000,344000,0
990816,5,NA,344000,344000,0
990816,6,40,344000,344000,0
990816,7,28,344000,334000,-10000
990816,8,34,334000,324000,-10000
990816,9,75,324000,344000,20000
990816,10,41,344000,358000,14000
990816,11,43,358000,367000,9000
990816,12,NA,367000,367000,0
990816,13,58,367000,383000,16000
990816,14,50,383000,398000,15000
990816,15,26,398000,388000,-10000
990816,16,42,388000,379000,-9000
990816,17,47,379000,375000,-4000
990816,18,NA,375000,375000,0
990816,19,NA,375000,375000,0
990816,20,NA,375000,375000,0
990816,21,36,375000,365000,-10000
990816,22,56,365000,368000,3000
990816,23,47,368000,375000,7000
990816,24,NA,375000,375000,0
990827,1,89,655000,665000,10000
990827,2,78,665000,673000,8000
990827,3,42,673000,652000,-21000
990827,4,34,652000,606000,-46000
990827,5,NA,606000,606000,0
990827,6,NA,606000,606000,0
990827,7,NA,606000,606000,0
990827,8,49,606000,561000,-45000
990827,9,67,561000,534000,-27000
990827,10,67,534000,521000,-13000
990827,11,32,521000,498000,-23000
990827,12,43,498000,475000,-23000
990827,13,74,475000,474000,-1000
990827,14,84,474000,496000,22000
990827,15,NA,496000,496000,0
990827,16,35,496000,493000,-3000
990827,17,75,493000,505000,12000
990827,18,44,505000,501000,-4000
990827,19,107,501000,529000,28000
990827,20,64,529000,546000,17000
990827,21,49,546000,548000,2000
990827,22,61,548000,545000,-3000
990827,23,61,545000,539000,-6000
990827,24,64,539000,529000,-10000
990840,1,NA,459000,459000,0
990840,2,NA,459000,459000,0
990840,3,NA,459000,459000,0
990840,4,NA,459000,459000,0
990840,5,NA,459000,459000,0
990840,6,NA,459000,459000,0
990840,7,NA,459000,459000,0
990840,8,NA,459000,459000,0
990840,9,NA,459000,459000,0
990840,10,NA,459000,459000,0
990840,11,NA,459000,459000,0
990840,12,NA,459000,459000,0
990840,13,NA,459000,459000,0
990840,14,NA,459000,459000,0
990840,15,NA,459000,459000,0
990840,16,NA,459000,459000,0
990840,17,NA,459000,459000,0
990840,18,NA,459000,459000,0
990840,19,NA,459000,459000,0
990840,20,NA,459000,459000,0
990840,21,NA,459000,459000,0
990840,22,NA,459000,459000,0
990840,23,NA,459000,459000,0
990840,24,43,459000,449000,-10000
990882,1,52,441000,442000,1000
990882,2,NA,442000,442000,0
990882,3,56,442000,446000,4000
990882,4,66,446000,458000,12000
990882,5,94,458000,496000,38000
990882,6,36,496000,504000,8000
990882,7,50,504000,501000,-3000
990882,8,63,501000,500000,-1000
990882,9,85,500000,516000,16000
990882,10,77,516000,536000,20000
990882,11,84,536000,565000,29000
990882,12,73,565000,588000,23000
990882,13,57,588000,591000,3000
990882,14,NA,591000,591000,0
990882,15,69,591000,590000,-1000
990882,16,74,590000,591000,1000
990882,17,60,591000,583000,-8000
990882,18,90,583000,593000,10000
990882,19,68,593000,599000,6000
990882,20,99,599000,623000,24000
990882,21,61,623000,628000,5000
990882,22,114,628000,659000,31000
990882,23,73,659000,672000,13000
990882,24,70,672000,670000,-2000
990978,1,NA,416000,416000,0
990978,2,NA,416000,416000,0
990978,3,NA,416000,416000,0
990978,4,54,416000,419000,3000
990978,5,59,419000,429000,10000
990978,6,73,429000,452000,23000
990978,7,43,452000,460000,8000
990978,8,52,460000,462000,2000
990978,9,56,462000,463000,1000
990978,10,38,463000,450000,-13000
990978,11,35,450000,428000,-22000
990978,12,53,428000,417000,-11000
990978,13,23,417000,391000,-26000
990978,14,NA,391000,391000,0
990978,15,NA,391000,391000,0
990978,16,NA,391000,391000,0
990978,17,NA,391000,391000,0
990978,18,NA,391000,391000,0
990978,19,NA,391000,391000,0
990978,20,NA,391000,391000,0
990978,21,0,391000,344000,-47000
990978,22,22,344000,302000,-42000
990978,23,NA,302000,302000,0
990978,24,NA,302000,302000,0
991773,1,NA,542000,542000,0
991773,2,49,542000,531000,-11000
991773,3,57,531000,520000,-11000
991773,4,36,520000,495000,-25000
991773,5,70,495000,489000,-6000
991773,6,79,489000,502000,13000
991773,7,63,502000,515000,13000
991773,8,86,515000,543000,28000
991773,9,NA,543000,543000,0
991773,10,NA,543000,543000,0
991773,11,NA,543000,543000,0
991773,12,27,543000,532000,-11000
991773,13,52,532000,516000,-16000
991773,14,NA,516000,516000,0
991773,15,NA,516000,516000,0
991773,16,73,516000,513000,-3000
991773,17,24,513000,485000,-28000
991773,18,18,485000,439000,-46000
991773,19,NA,439000,439000,0
991773,20,NA,439000,439000,0
991773,21,NA,439000,439000,0
991773,22,56,439000,416000,-23000
991773,23,38,416000,394000,-22000
991773,24,31,394000,369000,-25000
991930,1,79,694000,693000,-1000
991930,2,58,693000,677000,-16000
991930,3,75,677000,663000,-14000
991930,4,16,663000,609000,-54000
991930,5,61,609000,570000,-39000
991930,6,101,570000,572000,2000
991930,7,62,572000,572000,0
991930,8,66,572000,574000,2000
991930,9,NA,574000,574000,0
991930,10,97,574000,600000,26000
991930,11,57,600000,604000,4000
991930,12,46,604000,585000,-19000
991930,13,59,585000,566000,-19000
991930,14,74,566000,562000,-4000
991930,15,NA,562000,562000,0
991930,16,40,562000,538000,-24000
991930,17,74,538000,533000,-5000
991930,18,39,533000,515000,-18000
991930,19,NA,515000,515000,0
991930,20,27,515000,480000,-35000
991930,21,59,480000,459000,-21000
991930,22,86,459000,471000,12000
991930,23,61,471000,482000,11000
991930,24,49,482000,484000,2000
991933,1,NA,462000,462000,0
991933,2,NA,462000,462000,0
991933,3,NA,462000,462000,0
991933,4,NA,462000,462000,0
991933,5,NA,462000,462000,0
991933,6,NA,462000,462000,0
991933,7,NA,462000,462000,0
991933,8,NA,462000,462000,0
991933,9,NA,462000,462000,0
991933,10,NA,462000,462000,0
991933,11,NA,462000,462000,0
991933,12,NA,462000,462000,0
991933,13,NA,462000,462000,0
991933,14,NA,462000,462000,0
991933,15,NA,462000,462000,0
991933,16,NA,462000,462000,0
991933,17,NA,462000,462000,0
991933,18,NA,462000,462000,0
991933,19,NA,462000,462000,0
991933,20,NA,462000,462000,0
991933,21,NA,462000,462000,0
991933,22,NA,462000,462000,0
991933,23,NA,462000,462000,0
991933,24,NA,462000,462000,0
991939,1,25,301000,294000,-7000
991939,2,82,294000,324000,30000
991939,3,14,324000,327000,3000
991939,4,39,327000,329000,2000
991939,5,22,329000,318000,-11000
991939,6,48,318000,318000,0
991939,7,15,318000,299000,-19000
991939,8,NA,299000,299000,0
991939,9,NA,299000,299000,0
991939,10,NA,299000,299000,0
991939,11,NA,299000,299000,0
991939,12,NA,299000,299000,0
991939,13,NA,299000,299000,0
991939,14,NA,299000,299000,0
991939,15,NA,299000,299000,0
991939,16,NA,299000,299000,0
991939,17,12,299000,273000,-26000
991939,18,NA,273000,273000,0
991939,19,NA,273000,273000,0
991939,20,34,273000,258000,-15000
991939,21,33,258000,252000,-6000
991939,22,68,252000,275000,23000
991939,23,61,275000,312000,37000
991939,24,56,312000,349000,37000
991988,1,NA,579000,579000,0
991988,2,NA,579000,579000,0
991988,3,NA,579000,579000,0
991988,4,NA,579000,579000,0
991988,5,NA,579000,579000,0
991988,6,NA,579000,579000,0
991988,7,NA,579000,579000,0
991988,8,NA,579000,579000,0
991988,9,NA,579000,579000,0
991988,10,NA,579000,579000,0
991988,11,NA,579000,579000,0
991988,12,NA,579000,579000,0
991988,13,NA,579000,579000,0
991988,14,NA,579000,579000,0
991988,15,NA,579000,579000,0
991988,16,NA,579000,579000,0
991988,17,60,579000,572000,-7000
991988,18,79,572000,575000,3000
991988,19,74,575000,582000,7000
991988,20,5,582000,541000,-41000
991988,21,NA,541000,541000,0
991988,22,NA,541000,541000,0
991988,23,NA,541000,541000,0
991988,24,NA,541000,541000,0
992010,1,75,641000,642000,1000
992010,2,37,642000,615000,-27000
992010,3,71,615000,597000,-18000
992010,4,75,597000,589000,-8000
992010,5,82,589000,596000,7000
992010,6,87,596000,615000,19000
992010,7,57,615000,618000,3000
992010,8,44,618000,598000,-20000
992010,9,69,598000,583000,-15000
992010,10,52,583000,559000,-24000
992010,11,87,559000,560000,1000
992010,12,50,560000,551000,-9000
992010,13,102,551000,574000,23000
992010,14,NA,574000,574000,0
992010,15,97,574000,611000,37000
992010,16,72,611000,634000,23000
992010,17,NA,634000,634000,0
992010,18,101,634000,664000,30000
992010,19,56,664000,666000,2000
992010,20,93,666000,673000,7000
992010,21,56,673000,659000,-14000
992010,22,90,659000,657000,-2000
992010,23,93,657000,666000,9000
992010,24,96,666000,683000,17000
992016,1,107,949000,947000,-2000
992016,2,100,947000,939000,-8000
992016,3,103,939000,929000,-10000
992016,4,109,929000,923000,-6000
992016,5,119,923000,928000,5000
992016,6,NA,928000,928000,0
992016,7,82,928000,913000,-15000
992016,8,120,913000,913000,0
992016,9,83,913000,896000,-17000
992016,10,158,896000,921000,25000
992016,11,111,921000,939000,18000
992016,12,155,939000,982000,43000
992016,13,97,982000,994000,12000
992016,14,NA,994000,994000,0
992016,15,109,994000,998000,4000
992016,16,114,998000,993000,-5000
992016,17,150,993000,1010000,17000
992016,18,80,1010000,991000,-19000
992016,19,88,991000,960000,-31000
992016,20,140,960000,960000,0
992016,21,128,960000,970000,10000
992016,22,90,970000,957000,-13000
992016,23,94,957000,939000,-18000
992016,24,146,939000,949000,10000
992048,1,63,442000,451000,9000
992048,2,48,451000,454000,3000
992048,3,55,454000,458000,4000
992048,4,46,458000,454000,-4000
992048,5,44,454000,445000,-9000
992048,6,37,445000,428000,-17000
992048,7,51,428000,418000,-10000
992048,8,58,418000,419000,1000
992048,9,58,419000,427000,8000
992048,10,64,427000,442000,15000
992048,11,48,442000,450000,8000
992048,12,47,450000,448000,-2000
992048,13,47,448000,442000,-6000
992048,14,43,442000,433000,-9000
992048,15,NA,433000,433000,0
992048,16,39,433000,417000,-16000
992048,17,18,417000,385000,-32000
992048,18,47,385000,367000,-18000
992048,19,62,367000,370000,3000
992048,20,88,370000,405000,35000
992048,21,22,405000,411000,6000
992048,22,NA,411000,411000,0
992048,23,35,411000,406000,-5000
992048,24,46,406000,397000,-9000
992049,1,79,867000,852000,-15000
992049,2,70,852000,820000,-32000
992049,3,NA,820000,820000,0
992049,4,NA,820000,820000,0
992049,5,NA,820000,820000,0
992049,6,117,820000,814000,-6000
992049,7,123,814000,831000,17000
992049,8,102,831000,847000,16000
992049,9,113,847000,869000,22000
992049,10,99,869000,880000,11000
992049,11,102,880000,881000,1000
992049,12,85,881000,865000,-16000
992049,13,103,865000,855000,-10000
992049,14,95,855000,849000,-6000
992049,15,NA,849000,849000,0
992049,16,25,849000,791000,-58000
992049,17,NA,791000,791000,0
992049,18,NA,791000,791000,0
992049,19,NA,791000,791000,0
992049,20,NA,791000,791000,0
992049,21,95,791000,755000,-36000
992049,22,99,755000,741000,-14000
992049,23,74,741000,723000,-18000
992049,24,99,723000,722000,-1000
992054,1,NA,457000,457000,0
992054,2,NA,457000,457000,0
992054,3,NA,457000,457000,0
992054,4,NA,457000,457000,0
992054,5,NA,457000,457000,0
992054,6,NA,457000,457000,0
992054,7,NA,457000,457000,0
992054,8,NA,457000,457000,0
992054,9,NA,457000,457000,0
992054,10,NA,457000,457000,0
992054,11,NA,457000,457000,0
992054,12,NA,457000,457000,0
992054,13,NA,457000,457000,0
992054,14,NA,457000,457000,0
992054,15,NA,457000,457000,0
992054,16,NA,457000,457000,0
992054,17,NA,457000,457000,0
992054,18,NA,457000,457000,0
992054,19,NA,457000,457000,0
992054,20,NA,457000,457000,0
992054,21,NA,457000,457000,0
992054,22,NA,457000,457000,0
992054,23,NA,457000,457000,0
992054,24,NA,457000,457000,0
992059,1,86,557000,573000,16000
992059,2,69,573000,587000,14000
992059,3,104,587000,622000,35000
992059,4,44,622000,622000,0
992059,5,2,622000,570000,-52000
992059,6,NA,570000,570000,0
992059,7,71,570000,537000,-33000
992059,8,60,537000,514000,-23000
992059,9,57,514000,497000,-17000
992059,10,65,497000,496000,-1000
992059,11,61,496000,503000,7000
992059,12,NA,503000,503000,0
992059,13,61,503000,506000,3000
992059,14,50,506000,504000,-2000
992059,15,60,504000,501000,-3000
992059,16,42,501000,487000,-14000
992059,17,47,487000,470000,-17000
992059,18,31,470000,443000,-27000
992059,19,84,443000,448000,5000
992059,20,74,448000,468000,20000
992059,21,78,468000,498000,30000
992059,22,81,498000,533000,35000
992059,23,81,533000,568000,35000
992059,24,81,568000,592000,24000
992128,1,95,704000,714000,10000
992128,2,37,714000,688000,-26000
992128,3,NA,688000,688000,0
992128,4,NA,688000,688000,0
992128,5,69,688000,662000,-26000
992128,6,75,662000,644000,-18000
992128,7,75,644000,632000,-12000
992128,8,76,632000,628000,-4000
992128,9,51,628000,613000,-15000
992128,10,57,613000,592000,-21000
992128,11,31,592000,552000,-40000
992128,12,57,552000,520000,-32000
992128,13,NA,520000,520000,0
992128,14,51,520000,497000,-23000
992128,15,NA,497000,497000,0
992128,16,69,497000,492000,-5000
992128,17,72,492000,501000,9000
992128,18,31,501000,489000,-12000
992128,19,92,489000,506000,17000
992128,20,56,506000,514000,8000
992128,21,91,514000,539000,25000
992128,22,85,539000,568000,29000
992128,23,38,568000,567000,-1000
992128,24,76,567000,567000,0
992242,1,92,893000,885000,-8000
992242,2,101,885000,878000,-7000
992242,3,81,878000,859000,-19000
992242,4,122,859000,862000,3000
992242,5,133,862000,889000,27000
992242,6,103,889000,908000,19000
992242,7,112,908000,923000,15000
992242,8,116,923000,938000,15000
992242,9,116,938000,947000,9000
992242,10,85,947000,931000,-16000
992242,11,135,931000,939000,8000
992242,12,128,939000,954000,15000
992242,13,105,954000,958000,4000
992242,14,NA,958000,958000,0
992242,15,172,958000,1005000,47000
992242,16,136,1005000,1049000,44000
992242,17,128,1049000,1074000,25000
992242,18,123,1074000,1085000,11000
992242,19,97,1085000,1067000,-18000
992242,20,134,1067000,1056000,-11000
992242,21,98,1056000,1030000,-26000
992242,22,91,1030000,992000,-38000
992242,23,96,992000,954000,-38000
992242,24,105,954000,924000,-30000
992330,1,NA,478000,478000,0
992330,2,NA,478000,478000,0
992330,3,NA,478000,478000,0
992330,4,NA,478000,478000,0
992330,5,NA,478000,478000,0
992330,6,NA,478000,478000,0
992330,7,NA,478000,478000,0
992330,8,NA,478000,478000,0
992330,9,NA,478000,478000,0
992330,10,NA,478000,478000,0
992330,11,NA,478000,478000,0
992330,12,NA,478000,478000,0
992330,13,NA,478000,478000,0
992330,14,NA,478000,478000,0
992330,15,NA,478000,478000,0
992330,16,NA,478000,478000,0
992330,17,NA,478000,478000,0
992330,18,NA,478000,478000,0
992330,19,NA,478000,478000,0
992330,20,NA,478000,478000,0
992330,21,NA,478000,478000,0
992330,22,NA,478000,478000,0
992330,23,NA,478000,478000,0
992330,24,NA,478000,478000,0
992351,1,62,508000,511000,3000
992351,2,67,511000,518000,7000
992351,3,74,518000,534000,16000
992351,4,71,534000,549000,15000
992351,5,39,549000,540000,-9000
992351,6,95,540000,558000,18000
992351,7,93,558000,586000,28000
992351,8,70,586000,605000,19000
992351,9,108,605000,642000,37000
992351,10,100,642000,683000,41000
992351,11,75,683000,700000,17000
992351,12,86,700000,710000,10000
992351,13,103,710000,728000,18000
992351,14,54,728000,717000,-11000
992351,15,NA,717000,717000,0
992351,16,69,717000,696000,-21000
992351,17,47,696000,658000,-38000
992351,18,87,658000,640000,-18000
992351,19,16,640000,587000,-53000
992351,20,56,587000,548000,-39000
992351,21,64,548000,525000,-23000
992351,22,89,525000,533000,8000
992351,23,42,533000,523000,-10000
992351,24,40,523000,505000,-18000
992374,1,26,466000,446000,-20000
992374,2,54,446000,433000,-13000
992374,3,75,433000,443000,10000
992374,4,76,443000,468000,25000
992374,5,40,468000,475000,7000
992374,6,85,475000,502000,27000
992374,7,44,502000,506000,4000
992374,8,39,506000,491000,-15000
992374,9,56,491000,478000,-13000
992374,10,73,478000,483000,5000
992374,11,70,483000,493000,10000
992374,12,NA,493000,493000,0
992374,13,75,493000,514000,21000
992374,14,67,514000,536000,22000
992374,15,60,536000,545000,9000
992374,16,57,545000,543000,-2000
992374,17,50,543000,530000,-13000
992374,18,56,530000,515000,-15000
992374,19,27,515000,482000,-33000
992374,20,86,482000,483000,1000
992374,21,64,483000,490000,7000
992374,22,51,490000,491000,1000
992374,23,61,491000,494000,3000
992374,24,69,494000,502000,8000
992462,1,NA,658000,658000,0
992462,2,24,658000,619000,-39000
992462,3,78,619000,595000,-24000
992462,4,60,595000,573000,-22000
992462,5,88,573000,577000,4000
992462,6,28,577000,555000,-22000
992462,7,65,555000,544000,-11000
992462,8,NA,544000,544000,0
992462,9,NA,544000,544000,0
992462,10,43,544000,520000,-24000
992462,11,73,520000,513000,-7000
992462,12,NA,513000,513000,0
992462,13,NA,513000,513000,0
992462,14,NA,513000,513000,0
992462,15,NA,513000,513000,0
992462,16,NA,513000,513000,0
992462,17,NA,513000,513000,0
992462,18,NA,513000,513000,0
992462,19,57,513000,507000,-6000
992462,20,NA,507000,507000,0
992462,21,NA,507000,507000,0
992462,22,NA,507000,507000,0
992462,23,84,507000,523000,16000
992462,24,39,523000,515000,-8000
992468,1,72,808000,792000,-16000
992468,2,116,792000,799000,7000
992468,3,100,799000,810000,11000
992468,4,107,810000,825000,15000
992468,5,134,825000,863000,38000
992468,6,100,863000,888000,25000
992468,7,159,888000,939000,51000
992468,8,83,939000,950000,11000
992468,9,116,950000,957000,7000
992468,10,110,957000,955000,-2000
992468,11,96,955000,941000,-14000
992468,12,NA,941000,941000,0
992468,13,129,941000,940000,-1000
992468,14,103,940000,943000,3000
992468,15,105,943000,938000,-5000
992468,16,130,938000,950000,12000
992468,17,148,950000,982000,32000
992468,18,99,982000,989000,7000
992468,19,123,989000,997000,8000
992468,20,114,997000,999000,2000
992468,21,116,999000,996000,-3000
992468,22,131,996000,1000000,4000
992468,23,141,1000000,1020000,20000
992468,24,132,1020000,1036000,16000
992499,1,60,419000,428000,9000
992499,2,59,428000,441000,13000
992499,3,45,441000,445000,4000
992499,4,36,445000,435000,-10000
992499,5,13,435000,401000,-34000
992499,6,40,401000,374000,-27000
992499,7,25,374000,343000,-31000
992499,8,NA,343000,343000,0
992499,9,NA,343000,343000,0
992499,10,NA,343000,343000,0
992499,11,NA,343000,343000,0
992499,12,NA,343000,343000,0
992499,13,NA,343000,343000,0
992499,14,NA,343000,343000,0
992499,15,NA,343000,343000,0
992499,16,NA,343000,343000,0
992499,17,NA,343000,343000,0
992499,18,NA,343000,343000,0
992499,19,NA,343000,343000,0
992499,20,37,343000,323000,-20000
992499,21,64,323000,331000,8000
992499,22,59,331000,354000,23000
992499,23,46,354000,372000,18000
992499,24,74,372000,403000,31000
992644,1,NA,758000,758000,0
992644,2,NA,758000,758000,0
992644,3,NA,758000,758000,0
992644,4,NA,758000,758000,0
992644,5,NA,758000,758000,0
992644,6,NA,758000,758000,0
992644,7,NA,758000,758000,0
992644,8,NA,758000,758000,0
992644,9,NA,758000,758000,0
992644,10,NA,758000,758000,0
992644,11,NA,758000,758000,0
992644,12,NA,758000,758000,0
992644,13,NA,758000,758000,0
992644,14,NA,758000,758000,0
992644,15,NA,758000,758000,0
992644,16,NA,758000,758000,0
992644,17,NA,758000,758000,0
992644,18,NA,758000,758000,0
992644,19,NA,758000,758000,0
992644,20,NA,758000,758000,0
992644,21,NA,758000,758000,0
992644,22,NA,758000,758000,0
992644,23,NA,758000,758000,0
992644,24,NA,758000,758000,0
993107,1,50,708000,685000,-23000
993107,2,39,685000,638000,-47000
993107,3,46,638000,587000,-51000
993107,4,49,587000,542000,-45000
993107,5,74,542000,526000,-16000
993107,6,75,526000,531000,5000
993107,7,66,531000,540000,9000
993107,8,80,540000,560000,20000
993107,9,53,560000,563000,3000
993107,10,27,563000,534000,-29000
993107,11,NA,534000,534000,0
993107,12,91,534000,533000,-1000
993107,13,81,533000,545000,12000
993107,14,84,545000,570000,25000
993107,15,NA,570000,570000,0
993107,16,94,570000,606000,36000
993107,17,75,606000,632000,26000
993107,18,77,632000,645000,13000
993107,19,112,645000,676000,31000
993107,20,62,676000,681000,5000
993107,21,73,681000,676000,-5000
993107,22,87,676000,677000,1000
993107,23,114,677000,700000,23000
993107,24,82,700000,709000,9000
993480,1,31,430000,416000,-14000
993480,2,74,416000,425000,9000
993480,3,56,425000,437000,12000
993480,4,80,437000,465000,28000
993480,5,50,465000,481000,16000
993480,6,49,481000,486000,5000
993480,7,40,486000,473000,-13000
993480,8,36,473000,449000,-24000
993480,9,31,449000,417000,-32000
993480,10,54,417000,402000,-15000
993480,11,67,402000,408000,6000
993480,12,NA,408000,408000,0
993480,13,50,408000,415000,7000
993480,14,47,415000,423000,8000
993480,15,52,423000,428000,5000
993480,16,91,428000,459000,31000
993480,17,77,459000,493000,34000
993480,18,31,493000,494000,1000
993480,19,35,494000,478000,-16000
993480,20,NA,478000,478000,0
993480,21,NA,478000,478000,0
993480,22,NA,478000,478000,0
993480,23,NA,478000,478000,0
993480,24,NA,478000,478000,0
993771,1,30,573000,546000,-27000
993771,2,58,546000,523000,-23000
993771,3,68,523000,514000,-9000
993771,4,80,514000,524000,10000
993771,5,44,524000,521000,-3000
993771,6,80,521000,536000,15000
993771,7,88,536000,562000,26000
993771,8,64,562000,575000,13000
993771,9,18,575000,547000,-28000
993771,10,48,547000,517000,-30000
993771,11,50,517000,488000,-29000
993771,12,47,488000,461000,-27000
993771,13,49,461000,443000,-18000
993771,14,NA,443000,443000,0
993771,15,NA,443000,443000,0
993771,16,26,443000,420000,-23000
993771,17,39,420000,398000,-22000
993771,18,71,398000,402000,4000
993771,19,35,402000,397000,-5000
993771,20,53,397000,399000,2000
993771,21,54,399000,407000,8000
993771,22,34,407000,402000,-5000
993771,23,18,402000,375000,-27000
993771,24,NA,375000,375000,0
993794,1,102,604000,628000,24000
993794,2,44,628000,624000,-4000
993794,3,115,624000,652000,28000
993794,4,38,652000,641000,-11000
993794,5,64,641000,625000,-16000
993794,6,74,625000,614000,-11000
993794,7,112,614000,638000,24000
993794,8,86,638000,659000,21000
993794,9,86,659000,682000,23000
993794,10,63,682000,683000,1000
993794,11,74,683000,676000,-7000
993794,12,88,676000,673000,-3000
993794,13,91,673000,679000,6000
993794,14,NA,679000,679000,0
993794,15,117,679000,711000,32000
993794,16,54,711000,713000,2000
993794,17,92,713000,718000,5000
993794,18,77,718000,713000,-5000
993794,19,48,713000,682000,-31000
993794,20,80,682000,661000,-21000
993794,21,72,661000,646000,-15000
993794,22,93,646000,648000,2000
993794,23,96,648000,665000,17000
993794,24,97,665000,688000,23000
993795,1,NA,307000,307000,0
993795,2,NA,307000,307000,0
993795,3,NA,307000,307000,0
993795,4,NA,307000,307000,0
993795,5,NA,307000,307000,0
993795,6,NA,307000,307000,0
993795,7,NA,307000,307000,0
993795,8,NA,307000,307000,0
993795,9,NA,307000,307000,0
993795,10,NA,307000,307000,0
993795,11,NA,307000,307000,0
993795,12,NA,307000,307000,0
993795,13,NA,307000,307000,0
993795,14,44,307000,314000,7000
993795,15,NA,314000,314000,0
993795,16,74,314000,344000,30000
993795,17,68,344000,384000,40000
993795,18,50,384000,412000,28000
993795,19,63,412000,437000,25000
993795,20,49,437000,448000,11000
993795,21,75,448000,467000,19000
993795,22,62,467000,481000,14000
993795,23,34,481000,473000,-8000
993795,24,74,473000,478000,5000
993797,1,NA,326000,326000,0
993797,2,NA,326000,326000,0
993797,3,NA,326000,326000,0
993797,4,NA,326000,326000,0
993797,5,22,326000,314000,-12000
993797,6,NA,314000,314000,0
993797,7,NA,314000,314000,0
993797,8,NA,314000,314000,0
993797,9,NA,314000,314000,0
993797,10,NA,314000,314000,0
993797,11,NA,314000,314000,0
993797,12,NA,314000,314000,0
993797,13,NA,314000,314000,0
993797,14,NA,314000,314000,0
993797,15,NA,314000,314000,0
993797,16,NA,314000,314000,0
993797,17,NA,314000,314000,0
993797,18,NA,314000,314000,0
993797,19,NA,314000,314000,0
993797,20,NA,314000,314000,0
993797,21,NA,314000,314000,0
993797,22,NA,314000,314000,0
993797,23,NA,314000,314000,0
993797,24,NA,314000,314000,0
993799,1,33,636000,606000,-30000
993799,2,40,606000,563000,-43000
993799,3,NA,563000,563000,0
993799,4,NA,563000,563000,0
993799,5,60,563000,530000,-33000
993799,6,78,530000,523000,-7000
993799,7,112,523000,559000,36000
993799,8,89,559000,603000,44000
993799,9,65,603000,627000,24000
993799,10,80,627000,644000,17000
993799,11,33,644000,619000,-25000
993799,12,60,619000,589000,-30000
993799,13,NA,589000,589000,0
993799,14,75,589000,577000,-12000
993799,15,115,577000,603000,26000
993799,16,95,603000,639000,36000
993799,17,65,639000,657000,18000
993799,18,28,657000,632000,-25000
993799,19,NA,632000,632000,0
993799,20,NA,632000,632000,0
993799,21,NA,632000,632000,0
993799,22,NA,632000,632000,0
993799,23,86,632000,620000,-12000
993799,24,90,620000,617000,-3000
993806,1,71,399000,417000,18000
993806,2,NA,417000,417000,0
993806,3,55,417000,435000,18000
993806,4,13,435000,419000,-16000
993806,5,NA,419000,419000,0
993806,6,76,419000,427000,8000
993806,7,87,427000,457000,30000
993806,8,57,457000,477000,20000
993806,9,14,477000,461000,-16000
993806,10,76,461000,466000,5000
993806,11,50,466000,462000,-4000
993806,12,18,462000,431000,-31000
993806,13,50,431000,412000,-19000
993806,14,NA,412000,412000,0
993806,15,36,412000,396000,-16000
993806,16,49,396000,386000,-10000
993806,17,25,386000,366000,-20000
993806,18,41,366000,356000,-10000
993806,19,NA,356000,356000,0
993806,20,NA,356000,356000,0
993806,21,NA,356000,356000,0
993806,22,NA,356000,356000,0
993806,23,NA,356000,356000,0
993806,24,44,356000,348000,-8000
993816,1,NA,457000,457000,0
993816,2,NA,457000,457000,0
993816,3,23,457000,434000,-23000
993816,4,79,434000,438000,4000
993816,5,46,438000,438000,0
993816,6,76,438000,458000,20000
993816,7,66,458000,479000,21000
993816,8,67,479000,502000,23000
993816,9,12,502000,479000,-23000
993816,10,NA,479000,479000,0
993816,11,NA,479000,479000,0
993816,12,90,479000,486000,7000
993816,13,55,486000,487000,1000
993816,14,NA,487000,487000,0
993816,15,NA,487000,487000,0
993816,16,88,487000,510000,23000
993816,17,57,510000,523000,13000
993816,18,65,523000,536000,13000
993816,19,87,536000,556000,20000
993816,20,57,556000,562000,6000
993816,21,54,562000,554000,-8000
993816,22,58,554000,544000,-10000
993816,23,52,544000,528000,-16000
993816,24,63,528000,514000,-14000
993817,1,107,888000,891000,3000
993817,2,103,891000,894000,3000
993817,3,120,894000,908000,14000
993817,4,96,908000,908000,0
993817,5,105,908000,908000,0
993817,6,94,908000,899000,-9000
993817,7,121,899000,904000,5000
993817,8,117,904000,914000,10000
993817,9,NA,914000,914000,0
993817,10,NA,914000,914000,0
993817,11,NA,914000,914000,0
993817,12,NA,914000,914000,0
993817,13,NA,914000,914000,0
993817,14,NA,914000,914000,0
993817,15,83,914000,904000,-10000
993817,16,125,904000,912000,8000
993817,17,126,912000,929000,17000
993817,18,93,929000,925000,-4000
993817,19,108,925000,922000,-3000
993817,20,93,922000,910000,-12000
993817,21,113,910000,904000,-6000
993817,22,112,904000,902000,-2000
993817,23,96,902000,895000,-7000
993817,24,112,895000,892000,-3000
993820,1,70,349000,371000,22000
993820,2,40,371000,385000,14000
993820,3,78,385000,418000,33000
993820,4,46,418000,435000,17000
993820,5,NA,435000,435000,0
993820,6,NA,435000,435000,0
993820,7,NA,435000,435000,0
993820,8,NA,435000,435000,0
993820,9,NA,435000,435000,0
993820,10,NA,435000,435000,0
993820,11,NA,435000,435000,0
993820,12,NA,435000,435000,0
993820,13,NA,435000,435000,0
993820,14,NA,435000,435000,0
993820,15,NA,435000,435000,0
993820,16,NA,435000,435000,0
993820,17,23,435000,423000,-12000
993820,18,97,423000,446000,23000
993820,19,78,446000,477000,31000
993820,20,68,477000,504000,27000
993820,21,92,504000,544000,40000
993820,22,46,544000,556000,12000
993820,23,73,556000,563000,7000
993820,24,80,563000,571000,8000
993828,1,NA,623000,623000,0
993828,2,NA,623000,623000,0
993828,3,NA,623000,623000,0
993828,4,NA,623000,623000,0
993828,5,NA,623000,623000,0
993828,6,NA,623000,623000,0
993828,7,NA,623000,623000,0
993828,8,NA,623000,623000,0
993828,9,NA,623000,623000,0
993828,10,NA,623000,623000,0
993828,11,NA,623000,623000,0
993828,12,NA,623000,623000,0
993828,13,NA,623000,623000,0
993828,14,NA,623000,623000,0
993828,15,NA,623000,623000,0
993828,16,NA,623000,623000,0
993828,17,NA,623000,623000,0
993828,18,NA,623000,623000,0
993828,19,NA,623000,623000,0
993828,20,NA,623000,623000,0
993828,21,NA,623000,623000,0
993828,22,NA,623000,623000,0
993828,23,NA,623000,623000,0
993828,24,NA,623000,623000,0
993832,1,95,483000,512000,29000
993832,2,63,512000,536000,24000
993832,3,72,536000,558000,22000
993832,4,85,558000,585000,27000
993832,5,59,585000,592000,7000
993832,6,89,592000,609000,17000
993832,7,79,609000,623000,14000
993832,8,48,623000,614000,-9000
993832,9,56,614000,594000,-20000
993832,10,39,594000,559000,-35000
993832,11,98,559000,559000,0
993832,12,69,559000,562000,3000
993832,13,64,562000,565000,3000
993832,14,63,565000,569000,4000
993832,15,NA,569000,569000,0
993832,16,74,569000,576000,7000
993832,17,59,576000,570000,-6000
993832,18,40,570000,547000,-23000
993832,19,78,547000,542000,-5000
993832,20,89,542000,557000,15000
993832,21,77,557000,574000,17000
993832,22,74,574000,591000,17000
993832,23,74,591000,605000,14000
993832,24,75,605000,610000,5000
993834,1,77,963000,938000,-25000
993834,2,97,938000,912000,-26000
993834,3,116,912000,902000,-10000
993834,4,81,902000,879000,-23000
993834,5,102,879000,868000,-11000
993834,6,86,868000,853000,-15000
993834,7,115,853000,854000,1000
993834,8,172,854000,906000,52000
993834,9,88,906000,928000,22000
993834,10,125,928000,951000,23000
993834,11,112,951000,965000,14000
993834,12,NA,965000,965000,0
993834,13,145,965000,990000,25000
993834,14,113,990000,1004000,14000
993834,15,120,1004000,1013000,9000
993834,16,72,1013000,985000,-28000
993834,17,NA,985000,985000,0
993834,18,NA,985000,985000,0
993834,19,112,985000,960000,-25000
993834,20,137,960000,960000,0
993834,21,81,960000,938000,-22000
993834,22,61,938000,891000,-47000
993834,23,102,891000,862000,-29000
993834,24,78,862000,822000,-40000
993841,1,NA,478000,478000,0
993841,2,NA,478000,478000,0
993841,3,NA,478000,478000,0
993841,4,NA,478000,478000,0
993841,5,NA,478000,478000,0
993841,6,NA,478000,478000,0
993841,7,42,478000,467000,-11000
993841,8,NA,467000,467000,0
993841,9,NA,467000,467000,0
993841,10,NA,467000,467000,0
993841,11,NA,467000,467000,0
993841,12,NA,467000,467000,0
993841,13,NA,467000,467000,0
993841,14,NA,467000,467000,0
993841,15,NA,467000,467000,0
993841,16,NA,467000,467000,0
993841,17,NA,467000,467000,0
993841,18,NA,467000,467000,0
993841,19,NA,467000,467000,0
993841,20,NA,467000,467000,0
993841,21,NA,467000,467000,0
993841,22,NA,467000,467000,0
993841,23,8,467000,425000,-42000
993841,24,NA,425000,425000,0
993902,1,57,603000,594000,-9000
993902,2,110,594000,618000,24000
993902,3,69,618000,632000,14000
993902,4,50,632000,623000,-9000
993902,5,70,623000,616000,-7000
993902,6,72,616000,611000,-5000
993902,7,68,611000,602000,-9000
993902,8,85,602000,608000,6000
993902,9,83,608000,623000,15000
993902,10,NA,623000,623000,0
993902,11,NA,623000,623000,0
993902,12,NA,623000,623000,0
993902,13,NA,623000,623000,0
993902,14,NA,623000,623000,0
993902,15,NA,623000,623000,0
993902,16,NA,623000,623000,0
993902,17,NA,623000,623000,0
993902,18,NA,623000,623000,0
993902,19,NA,623000,623000,0
993902,20,NA,623000,623000,0
993902,21,NA,623000,623000,0
993902,22,NA,623000,623000,0
993902,23,NA,623000,623000,0
993902,24,NA,623000,623000,0
993903,1,71,716000,708000,-8000
993903,2,109,708000,722000,14000
993903,3,NA,722000,722000,0
993903,4,82,722000,728000,6000
993903,5,111,728000,752000,24000
993903,6,100,752000,777000,25000
993903,7,61,777000,769000,-8000
993903,8,111,769000,777000,8000
993903,9,47,777000,749000,-28000
993903,10,NA,749000,749000,0
993903,11,NA,749000,749000,0
993903,12,NA,749000,749000,0
993903,13,NA,749000,749000,0
993903,14,NA,749000,749000,0
993903,15,NA,749000,749000,0
993903,16,103,749000,740000,-9000
993903,17,70,740000,723000,-17000
993903,18,94,723000,720000,-3000
993903,19,89,720000,720000,0
993903,20,77,720000,718000,-2000
993903,21,16,718000,667000,-51000
993903,22,NA,667000,667000,0
993903,23,98,667000,648000,-19000
993903,24,53,648000,616000,-32000
993905,1,87,983000,964000,-19000
993905,2,109,964000,948000,-16000
993905,3,95,948000,927000,-21000
993905,4,75,927000,890000,-37000
993905,5,91,890000,860000,-30000
993905,6,87,860000,835000,-25000
993905,7,81,835000,807000,-28000
993905,8,110,807000,803000,-4000
993905,9,3,803000,739000,-64000
993905,10,NA,739000,739000,0
993905,11,NA,739000,739000,0
993905,12,NA,739000,739000,0
993905,13,NA,739000,739000,0
993905,14,NA,739000,739000,0
993905,15,64,739000,683000,-56000
993905,16,85,683000,653000,-30000
993905,17,92,653000,646000,-7000
993905,18,71,646000,641000,-5000
993905,19,98,641000,661000,20000
993905,20,58,661000,660000,-1000
993905,21,117,660000,684000,24000
993905,22,69,684000,689000,5000
993905,23,51,689000,670000,-19000
993905,24,155,670000,707000,37000
993917,1,40,513000,499000,-14000
993917,2,47,499000,481000,-18000
993917,3,58,481000,471000,-10000
993917,4,30,471000,447000,-24000
993917,5,43,447000,427000,-20000
993917,6,46,427000,414000,-13000
993917,7,43,414000,403000,-11000
993917,8,50,403000,398000,-5000
993917,9,NA,398000,398000,0
993917,10,NA,398000,398000,0
993917,11,56,398000,404000,6000
993917,12,48,404000,407000,3000
993917,13,NA,407000,407000,0
993917,14,46,407000,411000,4000
993917,15,49,411000,413000,2000
993917,16,18,413000,391000,-22000
993917,17,NA,391000,391000,0
993917,18,60,391000,386000,-5000
993917,19,23,386000,367000,-19000
993917,20,NA,367000,367000,0
993917,21,NA,367000,367000,0
993917,22,NA,367000,367000,0
993917,23,NA,367000,367000,0
993917,24,NA,367000,367000,0
993940,1,NA,285000,285000,0
993940,2,NA,285000,285000,0
993940,3,NA,285000,285000,0
993940,4,NA,285000,285000,0
993940,5,54,285000,299000,14000
993940,6,62,299000,330000,31000
993940,7,NA,330000,330000,0
993940,8,NA,330000,330000,0
993940,9,NA,330000,330000,0
993940,10,NA,330000,330000,0
993940,11,NA,330000,330000,0
993940,12,NA,330000,330000,0
993940,13,NA,330000,330000,0
993940,14,NA,330000,330000,0
993940,15,NA,330000,330000,0
993940,16,NA,330000,330000,0
993940,17,NA,330000,330000,0
993940,18,81,330000,379000,49000
993940,19,70,379000,427000,48000
993940,20,104,427000,492000,65000
993940,21,59,492000,530000,38000
993940,22,79,530000,561000,31000
993940,23,99,561000,598000,37000
993940,24,47,598000,599000,1000
993946,1,95,862000,859000,-3000
993946,2,70,859000,835000,-24000
993946,3,74,835000,802000,-33000
993946,4,81,802000,772000,-30000
993946,5,83,772000,750000,-22000
993946,6,35,750000,702000,-48000
993946,7,44,702000,646000,-56000
993946,8,52,646000,596000,-50000
993946,9,71,596000,567000,-29000
993946,10,53,567000,542000,-25000
993946,11,109,542000,564000,22000
993946,12,123,564000,621000,57000
993946,13,99,621000,675000,54000
993946,14,NA,675000,675000,0
993946,15,90,675000,717000,42000
993946,16,132,717000,776000,59000
993946,17,91,776000,804000,28000
993946,18,70,804000,798000,-6000
993946,19,82,798000,784000,-14000
993946,20,62,784000,751000,-33000
993946,21,75,751000,718000,-33000
993946,22,65,718000,685000,-33000
993946,23,37,685000,636000,-49000
993946,24,85,636000,612000,-24000
993953,1,27,458000,439000,-19000
993953,2,34,439000,413000,-26000
993953,3,43,413000,392000,-21000
993953,4,52,392000,385000,-7000
993953,5,98,385000,421000,36000
993953,6,40,421000,441000,20000
993953,7,55,441000,456000,15000
993953,8,68,456000,474000,18000
993953,9,67,474000,490000,16000
993953,10,67,490000,503000,13000
993953,11,35,503000,495000,-8000
993953,12,NA,495000,495000,0
993953,13,78,495000,502000,7000
993953,14,76,502000,520000,18000
993953,15,78,520000,541000,21000
993953,16,69,541000,559000,18000
993953,17,69,559000,572000,13000
993953,18,50,572000,565000,-7000
993953,19,49,565000,546000,-19000
993953,20,57,546000,527000,-19000
993953,21,76,527000,525000,-2000
993953,22,61,525000,524000,-1000
993953,23,84,524000,541000,17000
993953,24,30,541000,526000,-15000
993979,1,95,680000,692000,12000
993979,2,78,692000,700000,8000
993979,3,75,700000,700000,0
993979,4,69,700000,689000,-11000
993979,5,36,689000,650000,-39000
993979,6,39,650000,599000,-51000
993979,7,72,599000,568000,-31000
993979,8,43,568000,534000,-34000
993979,9,74,534000,524000,-10000
993979,10,69,524000,527000,3000
993979,11,37,527000,514000,-13000
993979,12,80,514000,518000,4000
993979,13,43,518000,509000,-9000
993979,14,58,509000,503000,-6000
993979,15,NA,503000,503000,0
993979,16,44,503000,488000,-15000
993979,17,58,488000,480000,-8000
993979,18,76,480000,487000,7000
993979,19,84,487000,512000,25000
993979,20,29,512000,506000,-6000
993979,21,56,506000,500000,-6000
993979,22,54,500000,491000,-9000
993979,23,69,491000,490000,-1000
993979,24,74,490000,499000,9000
993993,1,88,658000,667000,9000
993993,2,64,667000,664000,-3000
993993,3,81,664000,665000,1000
993993,4,69,665000,658000,-7000
993993,5,71,658000,650000,-8000
993993,6,71,650000,641000,-9000
993993,7,71,641000,633000,-8000
993993,8,137,633000,674000,41000
993993,9,66,674000,690000,16000
993993,10,120,690000,728000,38000
993993,11,103,728000,763000,35000
993993,12,85,763000,778000,15000
993993,13,124,778000,805000,27000
993993,14,71,805000,809000,4000
993993,15,NA,809000,809000,0
993993,16,63,809000,784000,-25000
993993,17,107,784000,776000,-8000
993993,18,99,776000,776000,0
993993,19,80,776000,767000,-9000
993993,20,94,767000,767000,0
993993,21,40,767000,733000,-34000
993993,22,91,733000,711000,-22000
993993,23,124,711000,726000,15000
993993,24,78,726000,728000,2000
993998,1,86,846000,838000,-8000
993998,2,89,838000,826000,-12000
993998,3,NA,826000,826000,0
993998,4,94,826000,815000,-11000
993998,5,48,815000,775000,-40000
993998,6,NA,775000,775000,0
993998,7,102,775000,759000,-16000
993998,8,58,759000,728000,-31000
993998,9,82,728000,708000,-20000
993998,10,115,708000,718000,10000
993998,11,69,718000,718000,0
993998,12,7,718000,661000,-57000
993998,13,NA,661000,661000,0
993998,14,71,661000,626000,-35000
993998,15,NA,626000,626000,0
993998,16,67,626000,596000,-30000
993998,17,23,596000,543000,-53000
993998,18,NA,543000,543000,0
993998,19,NA,543000,543000,0
993998,20,71,543000,519000,-24000
993998,21,105,519000,542000,23000
993998,22,87,542000,572000,30000
993998,23,67,572000,592000,20000
993998,24,123,592000,641000,49000
994077,1,47,476000,470000,-6000
994077,2,NA,470000,470000,0
994077,3,NA,470000,470000,0
994077,4,NA,470000,470000,0
994077,5,53,470000,464000,-6000
994077,6,82,464000,481000,17000
994077,7,26,481000,470000,-11000
994077,8,33,470000,447000,-23000
994077,9,38,447000,423000,-24000
994077,10,NA,423000,423000,0
994077,11,NA,423000,423000,0
994077,12,NA,423000,423000,0
994077,13,NA,423000,423000,0
994077,14,NA,423000,423000,0
994077,15,NA,423000,423000,0
994077,16,NA,423000,423000,0
994077,17,NA,423000,423000,0
994077,18,NA,423000,423000,0
994077,19,NA,423000,423000,0
994077,20,NA,423000,423000,0
994077,21,NA,423000,423000,0
994077,22,NA,423000,423000,0
994077,23,63,423000,415000,-8000
994077,24,50,415000,409000,-6000
994185,1,113,700000,724000,24000
994185,2,67,724000,729000,5000
994185,3,120,729000,758000,29000
994185,4,77,758000,766000,8000
994185,5,NA,766000,766000,0
994185,6,99,766000,777000,11000
994185,7,53,777000,753000,-24000
994185,8,60,753000,719000,-34000
994185,9,120,719000,720000,1000
994185,10,80,720000,718000,-2000
994185,11,127,718000,749000,31000
994185,12,58,749000,749000,0
994185,13,NA,749000,749000,0
994185,14,NA,749000,749000,0
994185,15,NA,749000,749000,0
994185,16,NA,749000,749000,0
994185,17,98,749000,757000,8000
994185,18,95,757000,762000,5000
994185,19,66,762000,746000,-16000
994185,20,90,746000,736000,-10000
994185,21,67,736000,718000,-18000
994185,22,72,718000,696000,-22000
994185,23,NA,696000,696000,0
994185,24,101,696000,693000,-3000
994295,1,58,815000,789000,-26000
994295,2,73,789000,756000,-33000
994295,3,85,756000,733000,-23000
994295,4,64,733000,704000,-29000
994295,5,106,704000,706000,2000
994295,6,77,706000,709000,3000
994295,7,117,709000,735000,26000
994295,8,99,735000,761000,26000
994295,9,84,761000,773000,12000
994295,10,115,773000,794000,21000
994295,11,78,794000,795000,1000
994295,12,84,795000,785000,-10000
994295,13,59,785000,754000,-31000
994295,14,108,754000,752000,-2000
994295,15,NA,752000,752000,0
994295,16,124,752000,774000,22000
994295,17,74,774000,777000,3000
994295,18,156,777000,825000,48000
994295,19,106,825000,863000,38000
994295,20,104,863000,884000,21000
994295,21,46,884000,853000,-31000
994295,22,129,853000,851000,-2000
994295,23,66,851000,820000,-31000
994295,24,119,820000,814000,-6000
994385,1,44,379000,379000,0
994385,2,86,379000,410000,31000
994385,3,84,410000,458000,48000
994385,4,95,458000,518000,60000
994385,5,69,518000,560000,42000
994385,6,90,560000,602000,42000
994385,7,93,602000,638000,36000
994385,8,82,638000,662000,24000
994385,9,54,662000,656000,-6000
994385,10,80,656000,652000,-4000
994385,11,120,652000,678000,26000
994385,12,78,678000,691000,13000
994385,13,37,691000,668000,-23000
994385,14,NA,668000,668000,0
994385,15,46,668000,634000,-34000
994385,16,78,634000,612000,-22000
994385,17,126,612000,633000,21000
994385,18,32,633000,619000,-14000
994385,19,83,619000,622000,3000
994385,20,102,622000,645000,23000
994385,21,82,645000,661000,16000
994385,22,79,661000,668000,7000
994385,23,84,668000,678000,10000
994385,24,41,678000,652000,-26000
994386,1,70,697000,689000,-8000
994386,2,74,689000,680000,-9000
994386,3,93,680000,684000,4000
994386,4,72,684000,681000,-3000
994386,5,58,681000,665000,-16000
994386,6,71,665000,651000,-14000
994386,7,57,651000,628000,-23000
994386,8,74,628000,613000,-15000
994386,9,89,613000,617000,4000
994386,10,57,617000,611000,-6000
994386,11,59,611000,598000,-13000
994386,12,88,598000,603000,5000
994386,13,NA,603000,603000,0
994386,14,44,603000,589000,-14000
994386,15,85,589000,590000,1000
994386,16,87,590000,605000,15000
994386,17,126,605000,653000,48000
994386,18,122,653000,713000,60000
994386,19,58,713000,734000,21000
994386,20,67,734000,729000,-5000
994386,21,80,729000,718000,-11000
994386,22,122,718000,730000,12000
994386,23,103,730000,749000,19000
994386,24,82,749000,757000,8000
994389,1,86,911000,897000,-14000
994389,2,110,897000,892000,-5000
994389,3,81,892000,872000,-20000
994389,4,103,872000,860000,-12000
994389,5,90,860000,847000,-13000
994389,6,93,847000,838000,-9000
994389,7,119,838000,845000,7000
994389,8,79,845000,838000,-7000
994389,9,72,838000,814000,-24000
994389,10,141,814000,831000,17000
994389,11,82,831000,830000,-1000
994389,12,NA,830000,830000,0
994389,13,107,830000,834000,4000
994389,14,100,834000,845000,11000
994389,15,130,845000,872000,27000
994389,16,101,872000,884000,12000
994389,17,110,884000,896000,12000
994389,18,86,896000,888000,-8000
994389,19,112,888000,886000,-2000
994389,20,106,886000,884000,-2000
994389,21,83,884000,868000,-16000
994389,22,121,868000,870000,2000
994389,23,136,870000,896000,26000
994389,24,103,896000,906000,10000
994539,1,NA,437000,437000,0
994539,2,68,437000,449000,12000
994539,3,93,449000,488000,39000
994539,4,65,488000,520000,32000
994539,5,51,520000,532000,12000
994539,6,50,532000,529000,-3000
994539,7,21,529000,493000,-36000
994539,8,NA,493000,493000,0
994539,9,NA,493000,493000,0
994539,10,NA,493000,493000,0
994539,11,NA,493000,493000,0
994539,12,NA,493000,493000,0
994539,13,39,493000,453000,-40000
994539,14,NA,453000,453000,0
994539,15,36,453000,418000,-35000
994539,16,NA,418000,418000,0
994539,17,NA,418000,418000,0
994539,18,48,418000,397000,-21000
994539,19,67,397000,401000,4000
994539,20,NA,401000,401000,0
994539,21,NA,401000,401000,0
994539,22,61,401000,417000,16000
994539,23,80,417000,449000,32000
994539,24,64,449000,476000,27000
994599,1,NA,639000,639000,0
994599,2,NA,639000,639000,0
994599,3,50,639000,620000,-19000
994599,4,NA,620000,620000,0
994599,5,NA,620000,620000,0
994599,6,NA,620000,620000,0
994599,7,35,620000,579000,-41000
994599,8,83,579000,563000,-16000
994599,9,62,563000,552000,-11000
994599,10,52,552000,537000,-15000
994599,11,56,537000,526000,-11000
994599,12,58,526000,518000,-8000
994599,13,1,518000,468000,-50000
994599,14,38,468000,428000,-40000
994599,15,NA,428000,428000,0
994599,16,55,428000,406000,-22000
994599,17,NA,406000,406000,0
994599,18,NA,406000,406000,0
994599,19,NA,406000,406000,0
994599,20,NA,406000,406000,0
994599,21,74,406000,412000,6000
994599,22,NA,412000,412000,0
994599,23,NA,412000,412000,0
994599,24,NA,412000,412000,0
996059,1,47,489000,482000,-7000
996059,2,94,482000,505000,23000
996059,3,108,505000,557000,52000
996059,4,76,557000,598000,41000
996059,5,53,598000,610000,12000
996059,6,41,610000,595000,-15000
996059,7,93,595000,596000,1000
996059,8,69,596000,592000,-4000
996059,9,97,592000,611000,19000
996059,10,64,611000,619000,8000
996059,11,19,619000,587000,-32000
996059,12,NA,587000,587000,0
996059,13,78,587000,569000,-18000
996059,14,27,569000,532000,-37000
996059,15,110,532000,540000,8000
996059,16,68,540000,553000,13000
996059,17,99,553000,588000,35000
996059,18,76,588000,614000,26000
996059,19,56,614000,619000,5000
996059,20,53,619000,602000,-17000
996059,21,75,602000,593000,-9000
996059,22,72,593000,586000,-7000
996059,23,46,586000,566000,-20000
996059,24,61,566000,550000,-16000
996232,1,NA,500000,500000,0
996232,2,32,500000,481000,-19000
996232,3,NA,481000,481000,0
996232,4,NA,481000,481000,0
996232,5,NA,481000,481000,0
996232,6,NA,481000,481000,0
996232,7,NA,481000,481000,0
996232,8,NA,481000,481000,0
996232,9,NA,481000,481000,0
996232,10,NA,481000,481000,0
996232,11,64,481000,471000,-10000
996232,12,83,471000,484000,13000
996232,13,45,484000,485000,1000
996232,14,NA,485000,485000,0
996232,15,40,485000,476000,-9000
996232,16,49,476000,466000,-10000
996232,17,88,466000,481000,15000
996232,18,37,481000,475000,-6000
996232,19,54,475000,471000,-4000
996232,20,56,471000,470000,-1000
996232,21,27,470000,449000,-21000
996232,22,67,449000,443000,-6000
996232,23,14,443000,414000,-29000
996232,24,NA,414000,414000,0
996442,1,NA,421000,421000,0
996442,2,NA,421000,421000,0
996442,3,NA,421000,421000,0
996442,4,NA,421000,421000,0
996442,5,NA,421000,421000,0
996442,6,49,421000,420000,-1000
996442,7,54,420000,423000,3000
996442,8,59,423000,432000,9000
996442,9,51,432000,438000,6000
996442,10,47,438000,437000,-1000
996442,11,32,437000,423000,-14000
996442,12,NA,423000,423000,0
996442,13,39,423000,404000,-19000
996442,14,NA,404000,404000,0
996442,15,65,404000,406000,2000
996442,16,NA,406000,406000,0
996442,17,NA,406000,406000,0
996442,18,10,406000,380000,-26000
996442,19,NA,380000,380000,0
996442,20,14,380000,343000,-37000
996442,21,39,343000,321000,-22000
996442,22,2,321000,281000,-40000
996442,23,19,281000,247000,-34000
996442,24,25,247000,226000,-21000
996464,1,83,548000,563000,15000
996464,2,67,563000,575000,12000
996464,3,96,575000,604000,29000
996464,4,84,604000,631000,27000
996464,5,90,631000,659000,28000
996464,6,109,659000,698000,39000
996464,7,119,698000,747000,49000
996464,8,102,747000,785000,38000
996464,9,55,785000,780000,-5000
996464,10,85,780000,768000,-12000
996464,11,67,768000,740000,-28000
996464,12,42,740000,687000,-53000
996464,13,NA,687000,687000,0
996464,14,76,687000,656000,-31000
996464,15,97,656000,653000,-3000
996464,16,82,653000,657000,4000
996464,17,74,657000,660000,3000
996464,18,73,660000,660000,0
996464,19,54,660000,642000,-18000
996464,20,65,642000,621000,-21000
996464,21,67,621000,603000,-18000
996464,22,66,603000,589000,-14000
996464,23,14,589000,542000,-47000
996464,24,84,542000,527000,-15000
996483,1,14,401000,377000,-24000
996483,2,61,377000,373000,-4000
996483,3,NA,373000,373000,0
996483,4,NA,373000,373000,0
996483,5,9,373000,345000,-28000
996483,6,34,345000,324000,-21000
996483,7,NA,324000,324000,0
996483,8,NA,324000,324000,0
996483,9,NA,324000,324000,0
996483,10,NA,324000,324000,0
996483,11,NA,324000,324000,0
996483,12,NA,324000,324000,0
996483,13,NA,324000,324000,0
996483,14,NA,324000,324000,0
996483,15,NA,324000,324000,0
996483,16,NA,324000,324000,0
996483,17,NA,324000,324000,0
996483,18,NA,324000,324000,0
996483,19,NA,324000,324000,0
996483,20,NA,324000,324000,0
996483,21,NA,324000,324000,0
996483,22,NA,324000,324000,0
996483,23,NA,324000,324000,0
996483,24,56,324000,323000,-1000
996554,1,NA,483000,483000,0
996554,2,110,483000,522000,39000
996554,3,61,522000,551000,29000
996554,4,71,551000,574000,23000
996554,5,107,574000,616000,42000
996554,6,99,616000,659000,43000
996554,7,54,659000,664000,5000
996554,8,65,664000,657000,-7000
996554,9,31,657000,618000,-39000
996554,10,84,618000,596000,-22000
996554,11,78,596000,589000,-7000
996554,12,55,589000,577000,-12000
996554,13,NA,577000,577000,0
996554,14,NA,577000,577000,0
996554,15,NA,577000,577000,0
996554,16,NA,577000,577000,0
996554,17,NA,577000,577000,0
996554,18,NA,577000,577000,0
996554,19,NA,577000,577000,0
996554,20,NA,577000,577000,0
996554,21,NA,577000,577000,0
996554,22,NA,577000,577000,0
996554,23,NA,577000,577000,0
996554,24,NA,577000,577000,0
996580,1,60,470000,474000,4000
996580,2,66,474000,486000,12000
996580,3,27,486000,472000,-14000
996580,4,65,472000,469000,-3000
996580,5,44,469000,460000,-9000
996580,6,31,460000,437000,-23000
996580,7,67,437000,435000,-2000
996580,8,65,435000,446000,11000
996580,9,54,446000,453000,7000
996580,10,61,453000,464000,11000
996580,11,79,464000,489000,25000
996580,12,NA,489000,489000,0
996580,13,61,489000,504000,15000
996580,14,56,504000,512000,8000
996580,15,55,512000,512000,0
996580,16,49,512000,503000,-9000
996580,17,48,503000,486000,-17000
996580,18,51,486000,472000,-14000
996580,19,69,472000,473000,1000
996580,20,55,473000,474000,1000
996580,21,27,474000,455000,-19000
996580,22,NA,455000,455000,0
996580,23,NA,455000,455000,0
996580,24,NA,455000,455000,0
996701,1,124,994000,1001000,7000
996701,2,149,1001000,1031000,30000
996701,3,111,1031000,1044000,13000
996701,4,129,1044000,1056000,12000
996701,5,108,1056000,1052000,-4000
996701,6,103,1052000,1034000,-18000
996701,7,125,1034000,1022000,-12000
996701,8,104,1022000,1004000,-18000
996701,9,126,1004000,999000,-5000
996701,10,108,999000,990000,-9000
996701,11,NA,990000,990000,0
996701,12,NA,990000,990000,0
996701,13,NA,990000,990000,0
996701,14,NA,990000,990000,0
996701,15,NA,990000,990000,0
996701,16,NA,990000,990000,0
996701,17,NA,990000,990000,0
996701,18,NA,990000,990000,0
996701,19,NA,990000,990000,0
996701,20,NA,990000,990000,0
996701,21,NA,990000,990000,0
996701,22,126,990000,991000,1000
996701,23,66,991000,955000,-36000
996701,24,101,955000,921000,-34000
996708,1,54,797000,769000,-28000
996708,2,62,769000,729000,-40000
996708,3,90,729000,707000,-22000
996708,4,115,707000,718000,11000
996708,5,46,718000,702000,-16000
996708,6,52,702000,674000,-28000
996708,7,89,674000,664000,-10000
996708,8,60,664000,643000,-21000
996708,9,106,643000,651000,8000
996708,10,130,651000,698000,47000
996708,11,81,698000,728000,30000
996708,12,118,728000,768000,40000
996708,13,99,768000,797000,29000
996708,14,86,797000,809000,12000
996708,15,NA,809000,809000,0
996708,16,96,809000,811000,2000
996708,17,78,811000,799000,-12000
996708,18,68,799000,769000,-30000
996708,19,79,769000,743000,-26000
996708,20,137,743000,762000,19000
996708,21,107,762000,787000,25000
996708,22,65,787000,785000,-2000
996708,23,80,785000,776000,-9000
996708,24,63,776000,744000,-32000
996731,1,50,678000,657000,-21000
996731,2,94,657000,656000,-1000
996731,3,78,656000,656000,0
996731,4,114,656000,685000,29000
996731,5,63,685000,692000,7000
996731,6,97,692000,710000,18000
996731,7,151,710000,767000,57000
996731,8,63,767000,781000,14000
996731,9,69,781000,771000,-10000
996731,10,101,771000,772000,1000
996731,11,110,772000,782000,10000
996731,12,59,782000,760000,-22000
996731,13,79,760000,742000,-18000
996731,14,79,742000,731000,-11000
996731,15,NA,731000,731000,0
996731,16,92,731000,724000,-7000
996731,17,79,724000,715000,-9000
996731,18,98,715000,722000,7000
996731,19,146,722000,770000,48000
996731,20,100,770000,806000,36000
996731,21,50,806000,797000,-9000
996731,22,58,797000,763000,-34000
996731,23,101,763000,745000,-18000
996731,24,65,745000,710000,-35000
996743,1,NA,293000,293000,0
996743,2,NA,293000,293000,0
996743,3,NA,293000,293000,0
996743,4,NA,293000,293000,0
996743,5,NA,293000,293000,0
996743,6,NA,293000,293000,0
996743,7,NA,293000,293000,0
996743,8,NA,293000,293000,0
996743,9,NA,293000,293000,0
996743,10,NA,293000,293000,0
996743,11,46,293000,300000,7000
996743,12,NA,300000,300000,0
996743,13,26,300000,299000,-1000
996743,14,54,299000,313000,14000
996743,15,29,313000,315000,2000
996743,16,55,315000,329000,14000
996743,17,58,329000,350000,21000
996743,18,18,350000,347000,-3000
996743,19,NA,347000,347000,0
996743,20,NA,347000,347000,0
996743,21,NA,347000,347000,0
996743,22,NA,347000,347000,0
996743,23,NA,347000,347000,0
996743,24,NA,347000,347000,0
996765,1,57,630000,619000,-11000
996765,2,85,619000,620000,1000
996765,3,55,620000,609000,-11000
996765,4,70,609000,601000,-8000
996765,5,118,601000,632000,31000
996765,6,53,632000,638000,6000
996765,7,48,638000,621000,-17000
996765,8,30,621000,580000,-41000
996765,9,75,580000,558000,-22000
996765,10,40,558000,522000,-36000
996765,11,72,522000,512000,-10000
996765,12,NA,512000,512000,0
996765,13,64,512000,511000,-1000
996765,14,41,511000,503000,-8000
996765,15,101,503000,526000,23000
996765,16,59,526000,539000,13000
996765,17,49,539000,536000,-3000
996765,18,77,536000,543000,7000
996765,19,77,543000,556000,13000
996765,20,83,556000,573000,17000
996765,21,66,573000,584000,11000
996765,22,91,584000,606000,22000
996765,23,46,606000,600000,-6000
996765,24,NA,600000,600000,0
997033,1,141,579000,634000,55000
997033,2,80,634000,679000,45000
997033,3,25,679000,668000,-11000
997033,4,64,668000,646000,-22000
997033,5,57,646000,616000,-30000
997033,6,47,616000,575000,-41000
997033,7,80,575000,561000,-14000
997033,8,70,561000,561000,0
997033,9,68,561000,564000,3000
997033,10,54,564000,558000,-6000
997033,11,90,558000,573000,15000
997033,12,NA,573000,573000,0
997033,13,39,573000,559000,-14000
997033,14,80,559000,563000,4000
997033,15,53,563000,555000,-8000
997033,16,122,555000,591000,36000
997033,17,51,591000,599000,8000
997033,18,NA,599000,599000,0
997033,19,NA,599000,599000,0
997033,20,NA,599000,599000,0
997033,21,36,599000,581000,-18000
997033,22,104,581000,592000,11000
997033,23,70,592000,598000,6000
997033,24,67,598000,593000,-5000
997078,1,104,754000,767000,13000
997078,2,103,767000,787000,20000
997078,3,66,787000,781000,-6000
997078,4,122,781000,798000,17000
997078,5,74,798000,794000,-4000
997078,6,84,794000,785000,-9000
997078,7,57,785000,753000,-32000
997078,8,72,753000,722000,-31000
997078,9,107,722000,717000,-5000
997078,10,107,717000,732000,15000
997078,11,125,732000,771000,39000
997078,12,80,771000,790000,19000
997078,13,89,790000,798000,8000
997078,14,NA,798000,798000,0
997078,15,57,798000,774000,-24000
997078,16,80,774000,748000,-26000
997078,17,76,748000,720000,-28000
997078,18,78,720000,700000,-20000
997078,19,100,700000,702000,2000
997078,20,62,702000,692000,-10000
997078,21,100,692000,699000,7000
997078,22,93,699000,711000,12000
997078,23,47,711000,691000,-20000
997078,24,91,691000,681000,-10000
997100,1,76,589000,595000,6000
997100,2,82,595000,609000,14000
997100,3,39,609000,595000,-14000
997100,4,59,595000,578000,-17000
997100,5,55,578000,558000,-20000
997100,6,35,558000,523000,-35000
997100,7,86,523000,519000,-4000
997100,8,78,519000,533000,14000
997100,9,41,533000,527000,-6000
997100,10,73,527000,532000,5000
997100,11,106,532000,567000,35000
997100,12,NA,567000,567000,0
997100,13,43,567000,568000,1000
997100,14,49,568000,559000,-9000
997100,15,NA,559000,559000,0
997100,16,60,559000,548000,-11000
997100,17,73,548000,544000,-4000
997100,18,56,544000,534000,-10000
997100,19,76,534000,540000,6000
997100,20,44,540000,531000,-9000
997100,21,40,531000,509000,-22000
997100,22,95,509000,519000,10000
997100,23,59,519000,523000,4000
997100,24,61,523000,523000,0
997142,1,78,595000,602000,7000
997142,2,68,602000,606000,4000
997142,3,77,606000,613000,7000
997142,4,84,613000,626000,13000
997142,5,76,626000,636000,10000
997142,6,89,636000,653000,17000
997142,7,130,653000,701000,48000
997142,8,44,701000,703000,2000
997142,9,NA,703000,703000,0
997142,10,40,703000,670000,-33000
997142,11,NA,670000,670000,0
997142,12,NA,670000,670000,0
997142,13,NA,670000,670000,0
997142,14,NA,670000,670000,0
997142,15,NA,670000,670000,0
997142,16,NA,670000,670000,0
997142,17,NA,670000,670000,0
997142,18,NA,670000,670000,0
997142,19,NA,670000,670000,0
997142,20,NA,670000,670000,0
997142,21,NA,670000,670000,0
997142,22,NA,670000,670000,0
997142,23,NA,670000,670000,0
997142,24,NA,670000,670000,0
997206,1,NA,367000,367000,0
997206,2,NA,367000,367000,0
997206,3,NA,367000,367000,0
997206,4,NA,367000,367000,0
997206,5,NA,367000,367000,0
997206,6,NA,367000,367000,0
997206,7,NA,367000,367000,0
997206,8,NA,367000,367000,0
997206,9,NA,367000,367000,0
997206,10,NA,367000,367000,0
997206,11,NA,367000,367000,0
997206,12,NA,367000,367000,0
997206,13,NA,367000,367000,0
997206,14,NA,367000,367000,0
997206,15,NA,367000,367000,0
997206,16,NA,367000,367000,0
997206,17,NA,367000,367000,0
997206,18,NA,367000,367000,0
997206,19,NA,367000,367000,0
997206,20,NA,367000,367000,0
997206,21,NA,367000,367000,0
997206,22,NA,367000,367000,0
997206,23,NA,367000,367000,0
997206,24,NA,367000,367000,0
997230,1,66,624000,620000,-4000
997230,2,49,620000,600000,-20000
997230,3,28,600000,556000,-44000
997230,4,47,556000,515000,-41000
997230,5,31,515000,471000,-44000
997230,6,NA,471000,471000,0
997230,7,NA,471000,471000,0
997230,8,NA,471000,471000,0
997230,9,NA,471000,471000,0
997230,10,55,471000,444000,-27000
997230,11,62,444000,438000,-6000
997230,12,56,438000,441000,3000
997230,13,NA,441000,441000,0
997230,14,45,441000,442000,1000
997230,15,42,442000,436000,-6000
997230,16,61,436000,438000,2000
997230,17,92,438000,467000,29000
997230,18,74,467000,498000,31000
997230,19,42,498000,507000,9000
997230,20,58,507000,510000,3000
997230,21,41,510000,495000,-15000
997230,22,52,495000,477000,-18000
997230,23,52,477000,463000,-14000
997230,24,72,463000,466000,3000
997254,1,NA,315000,315000,0
997254,2,NA,315000,315000,0
997254,3,NA,315000,315000,0
997254,4,NA,315000,315000,0
997254,5,NA,315000,315000,0
997254,6,11,315000,296000,-19000
997254,7,9,296000,263000,-33000
997254,8,NA,263000,263000,0
997254,9,NA,263000,263000,0
997254,10,NA,263000,263000,0
997254,11,NA,263000,263000,0
997254,12,NA,263000,263000,0
997254,13,NA,263000,263000,0
997254,14,NA,263000,263000,0
997254,15,NA,263000,263000,0
997254,16,NA,263000,263000,0
997254,17,NA,263000,263000,0
997254,18,NA,263000,263000,0
997254,19,NA,263000,263000,0
997254,20,NA,263000,263000,0
997254,21,NA,263000,263000,0
997254,22,NA,263000,263000,0
997254,23,NA,263000,263000,0
997254,24,NA,263000,263000,0
997316,1,80,496000,513000,17000
997316,2,57,513000,524000,11000
997316,3,39,524000,514000,-10000
997316,4,88,514000,527000,13000
997316,5,48,527000,525000,-2000
997316,6,75,525000,532000,7000
997316,7,64,532000,539000,7000
997316,8,40,539000,527000,-12000
997316,9,45,527000,505000,-22000
997316,10,65,505000,495000,-10000
997316,11,NA,495000,495000,0
997316,12,46,495000,479000,-16000
997316,13,30,479000,452000,-27000
997316,14,NA,452000,452000,0
997316,15,NA,452000,452000,0
997316,16,69,452000,449000,-3000
997316,17,72,449000,462000,13000
997316,18,NA,462000,462000,0
997316,19,33,462000,454000,-8000
997316,20,NA,454000,454000,0
997316,21,NA,454000,454000,0
997316,22,NA,454000,454000,0
997316,23,NA,454000,454000,0
997316,24,NA,454000,454000,0
997501,1,NA,411000,411000,0
997501,2,NA,411000,411000,0
997501,3,NA,411000,411000,0
997501,4,NA,411000,411000,0
997501,5,NA,411000,411000,0
997501,6,NA,411000,411000,0
997501,7,NA,411000,411000,0
997501,8,60,411000,419000,8000
997501,9,16,419000,401000,-18000
997501,10,49,401000,389000,-12000
997501,11,41,389000,378000,-11000
997501,12,72,378000,391000,13000
997501,13,NA,391000,391000,0
997501,14,NA,391000,391000,0
997501,15,NA,391000,391000,0
997501,16,30,391000,389000,-2000
997501,17,32,389000,380000,-9000
997501,18,19,380000,355000,-25000
997501,19,47,355000,342000,-13000
997501,20,22,342000,320000,-22000
997501,21,NA,320000,320000,0
997501,22,NA,320000,320000,0
997501,23,NA,320000,320000,0
997501,24,NA,320000,320000,0
997823,1,NA,466000,466000,0
997823,2,NA,466000,466000,0
997823,3,NA,466000,466000,0
997823,4,9,466000,431000,-35000
997823,5,30,431000,392000,-39000
997823,6,31,392000,357000,-35000
997823,7,29,357000,327000,-30000
997823,8,61,327000,328000,1000
997823,9,64,328000,352000,24000
997823,10,60,352000,381000,29000
997823,11,21,381000,383000,2000
997823,12,44,383000,381000,-2000
997823,13,NA,381000,381000,0
997823,14,NA,381000,381000,0
997823,15,NA,381000,381000,0
997823,16,NA,381000,381000,0
997823,17,NA,381000,381000,0
997823,18,NA,381000,381000,0
997823,19,NA,381000,381000,0
997823,20,NA,381000,381000,0
997823,21,67,381000,393000,12000
997823,22,50,393000,400000,7000
997823,23,85,400000,431000,31000
997823,24,52,431000,452000,21000
997846,1,62,373000,391000,18000
997846,2,65,391000,415000,24000
997846,3,59,415000,439000,24000
997846,4,81,439000,475000,36000
997846,5,60,475000,499000,24000
997846,6,57,499000,511000,12000
997846,7,88,511000,536000,25000
997846,8,55,536000,544000,8000
997846,9,60,544000,544000,0
997846,10,60,544000,540000,-4000
997846,11,64,540000,537000,-3000
997846,12,NA,537000,537000,0
997846,13,49,537000,523000,-14000
997846,14,59,523000,516000,-7000
997846,15,73,516000,520000,4000
997846,16,88,520000,542000,22000
997846,17,63,542000,555000,13000
997846,18,66,555000,565000,10000
997846,19,87,565000,583000,18000
997846,20,56,583000,584000,1000
997846,21,42,584000,563000,-21000
997846,22,57,563000,543000,-20000
997846,23,90,543000,548000,5000
997846,24,56,548000,542000,-6000
997933,1,33,514000,495000,-19000
997933,2,68,495000,489000,-6000
997933,3,57,489000,485000,-4000
997933,4,NA,485000,485000,0
997933,5,60,485000,487000,2000
997933,6,63,487000,494000,7000
997933,7,44,494000,489000,-5000
997933,8,54,489000,482000,-7000
997933,9,61,482000,481000,-1000
997933,10,32,481000,461000,-20000
997933,11,60,461000,454000,-7000
997933,12,47,454000,445000,-9000
997933,13,69,445000,451000,6000
997933,14,49,451000,455000,4000
997933,15,NA,455000,455000,0
997933,16,78,455000,476000,21000
997933,17,3,476000,450000,-26000
997933,18,NA,450000,450000,0
997933,19,NA,450000,450000,0
997933,20,NA,450000,450000,0
997933,21,NA,450000,450000,0
997933,22,NA,450000,450000,0
997933,23,NA,450000,450000,0
997933,24,NA,450000,450000,0
997974,1,NA,425000,425000,0
997974,2,NA,425000,425000,0
997974,3,60,425000,432000,7000
997974,4,72,432000,453000,21000
997974,5,53,453000,467000,14000
997974,6,56,467000,477000,10000
997974,7,33,477000,465000,-12000
997974,8,38,465000,443000,-22000
997974,9,70,443000,441000,-2000
997974,10,32,441000,426000,-15000
997974,11,35,426000,407000,-19000
997974,12,54,407000,401000,-6000
997974,13,10,401000,371000,-30000
997974,14,NA,371000,371000,0
997974,15,29,371000,342000,-29000
997974,16,NA,342000,342000,0
997974,17,61,342000,341000,-1000
997974,18,51,341000,348000,7000
997974,19,NA,348000,348000,0
997974,20,NA,348000,348000,0
997974,21,32,348000,348000,0
997974,22,NA,348000,348000,0
997974,23,NA,348000,348000,0
997974,24,NA,348000,348000,0
998102,1,81,719000,718000,-1000
998102,2,88,718000,721000,3000
998102,3,79,721000,719000,-2000
998102,4,65,719000,704000,-15000
998102,5,84,704000,696000,-8000
998102,6,67,696000,682000,-14000
998102,7,66,682000,662000,-20000
998102,8,75,662000,649000,-13000
998102,9,69,649000,637000,-12000
998102,10,117,637000,659000,22000
998102,11,94,659000,687000,28000
998102,12,73,687000,698000,11000
998102,13,80,698000,703000,5000
998102,14,NA,703000,703000,0
998102,15,107,703000,723000,20000
998102,16,64,723000,717000,-6000
998102,17,97,717000,720000,3000
998102,18,87,720000,724000,4000
998102,19,106,724000,741000,17000
998102,20,59,741000,730000,-11000
998102,21,62,730000,707000,-23000
998102,22,69,707000,680000,-27000
998102,23,100,680000,676000,-4000
998102,24,93,676000,680000,4000
998103,1,76,610000,614000,4000
998103,2,85,614000,628000,14000
998103,3,76,628000,639000,11000
998103,4,122,639000,680000,41000
998103,5,53,680000,686000,6000
998103,6,54,686000,670000,-16000
998103,7,38,670000,628000,-42000
998103,8,101,628000,620000,-8000
998103,9,57,620000,602000,-18000
998103,10,76,602000,598000,-4000
998103,11,48,598000,583000,-15000
998103,12,NA,583000,583000,0
998103,13,103,583000,599000,16000
998103,14,52,599000,596000,-3000
998103,15,50,596000,581000,-15000
998103,16,63,581000,567000,-14000
998103,17,103,567000,584000,17000
998103,18,103,584000,617000,33000
998103,19,65,617000,634000,17000
998103,20,60,634000,636000,2000
998103,21,55,636000,620000,-16000
998103,22,64,620000,599000,-21000
998103,23,72,599000,584000,-15000
998103,24,56,584000,566000,-18000
998114,1,NA,641000,641000,0
998114,2,NA,641000,641000,0
998114,3,104,641000,661000,20000
998114,4,34,661000,644000,-17000
998114,5,NA,644000,644000,0
998114,6,29,644000,600000,-44000
998114,7,36,600000,546000,-54000
998114,8,60,546000,509000,-37000
998114,9,NA,509000,509000,0
998114,10,NA,509000,509000,0
998114,11,NA,509000,509000,0
998114,12,61,509000,486000,-23000
998114,13,75,486000,491000,5000
998114,14,NA,491000,491000,0
998114,15,108,491000,535000,44000
998114,16,83,535000,580000,45000
998114,17,52,580000,594000,14000
998114,18,81,594000,608000,14000
998114,19,62,608000,605000,-3000
998114,20,NA,605000,605000,0
998114,21,71,605000,599000,-6000
998114,22,74,599000,597000,-2000
998114,23,67,597000,595000,-2000
998114,24,67,595000,588000,-7000
998128,1,71,844000,825000,-19000
998128,2,58,825000,783000,-42000
998128,3,22,783000,705000,-78000
998128,4,NA,705000,705000,0
998128,5,68,705000,647000,-58000
998128,6,79,647000,617000,-30000
998128,7,71,617000,602000,-15000
998128,8,68,602000,596000,-6000
998128,9,106,596000,624000,28000
998128,10,125,624000,676000,52000
998128,11,60,676000,694000,18000
998128,12,101,694000,717000,23000
998128,13,49,717000,704000,-13000
998128,14,NA,704000,704000,0
998128,15,47,704000,667000,-37000
998128,16,131,667000,678000,11000
998128,17,105,678000,705000,27000
998128,18,83,705000,722000,17000
998128,19,103,722000,748000,26000
998128,20,48,748000,736000,-12000
998128,21,106,736000,735000,-1000
998128,22,91,735000,735000,0
998128,23,73,735000,726000,-9000
998128,24,60,726000,699000,-27000
998129,1,76,845000,829000,-16000
998129,2,60,829000,792000,-37000
998129,3,NA,792000,792000,0
998129,4,NA,792000,792000,0
998129,5,52,792000,737000,-55000
998129,6,75,737000,696000,-41000
998129,7,72,696000,666000,-30000
998129,8,NA,666000,666000,0
998129,9,NA,666000,666000,0
998129,10,NA,666000,666000,0
998129,11,NA,666000,666000,0
998129,12,NA,666000,666000,0
998129,13,NA,666000,666000,0
998129,14,NA,666000,666000,0
998129,15,NA,666000,666000,0
998129,16,NA,666000,666000,0
998129,17,NA,666000,666000,0
998129,18,NA,666000,666000,0
998129,19,NA,666000,666000,0
998129,20,NA,666000,666000,0
998129,21,NA,666000,666000,0
998129,22,NA,666000,666000,0
998129,23,NA,666000,666000,0
998129,24,NA,666000,666000,0
998130,1,67,673000,665000,-8000
998130,2,70,665000,655000,-10000
998130,3,70,655000,643000,-12000
998130,4,94,643000,650000,7000
998130,5,49,650000,636000,-14000
998130,6,94,636000,644000,8000
998130,7,60,644000,637000,-7000
998130,8,NA,637000,637000,0
998130,9,NA,637000,637000,0
998130,10,46,637000,610000,-27000
998130,11,60,610000,584000,-26000
998130,12,48,584000,555000,-29000
998130,13,NA,555000,555000,0
998130,14,89,555000,555000,0
998130,15,110,555000,589000,34000
998130,16,62,589000,609000,20000
998130,17,63,609000,614000,5000
998130,18,96,614000,634000,20000
998130,19,49,634000,623000,-11000
998130,20,98,623000,631000,8000
998130,21,75,631000,638000,7000
998130,22,70,638000,638000,0
998130,23,107,638000,658000,20000
998130,24,79,658000,671000,13000
998133,1,51,666000,647000,-19000
998133,2,85,647000,641000,-6000
998133,3,68,641000,633000,-8000
998133,4,86,633000,637000,4000
998133,5,69,637000,637000,0
998133,6,50,637000,622000,-15000
998133,7,59,622000,601000,-21000
998133,8,114,601000,619000,18000
998133,9,37,619000,604000,-15000
998133,10,85,604000,606000,2000
998133,11,48,606000,592000,-14000
998133,12,NA,592000,592000,0
998133,13,71,592000,583000,-9000
998133,14,78,583000,584000,1000
998133,15,94,584000,605000,21000
998133,16,66,605000,615000,10000
998133,17,NA,615000,615000,0
998133,18,39,615000,597000,-18000
998133,19,65,597000,581000,-16000
998133,20,72,581000,571000,-10000
998133,21,113,571000,596000,25000
998133,22,78,596000,619000,23000
998133,23,77,619000,639000,20000
998133,24,118,639000,677000,38000
998134,1,60,630000,621000,-9000
998134,2,66,621000,610000,-11000
998134,3,72,610000,604000,-6000
998134,4,76,604000,604000,0
998134,5,116,604000,639000,35000
998134,6,49,639000,644000,5000
998134,7,30,644000,613000,-31000
998134,8,71,613000,592000,-21000
998134,9,60,592000,570000,-22000
998134,10,64,570000,552000,-18000
998134,11,56,552000,539000,-13000
998134,12,NA,539000,539000,0
998134,13,40,539000,517000,-22000
998134,14,69,517000,512000,-5000
998134,15,79,512000,521000,9000
998134,16,3,521000,487000,-34000
998134,17,NA,487000,487000,0
998134,18,62,487000,469000,-18000
998134,19,65,469000,465000,-4000
998134,20,89,465000,486000,21000
998134,21,70,486000,509000,23000
998134,22,68,509000,533000,24000
998134,23,59,533000,543000,10000
998134,24,40,543000,527000,-16000
998145,1,104,760000,772000,12000
998145,2,61,772000,760000,-12000
998145,3,128,760000,781000,21000
998145,4,92,781000,794000,13000
998145,5,118,794000,821000,27000
998145,6,112,821000,849000,28000
998145,7,94,849000,863000,14000
998145,8,76,863000,849000,-14000
998145,9,115,849000,850000,1000
998145,10,91,850000,841000,-9000
998145,11,34,841000,789000,-52000
998145,12,NA,789000,789000,0
998145,13,NA,789000,789000,0
998145,14,NA,789000,789000,0
998145,15,82,789000,751000,-38000
998145,16,126,751000,756000,5000
998145,17,124,756000,783000,27000
998145,18,74,783000,790000,7000
998145,19,NA,790000,790000,0
998145,20,NA,790000,790000,0
998145,21,NA,790000,790000,0
998145,22,NA,790000,790000,0
998145,23,NA,790000,790000,0
998145,24,NA,790000,790000,0
998172,1,123,846000,865000,19000
998172,2,108,865000,885000,20000
998172,3,111,885000,903000,18000
998172,4,114,903000,919000,16000
998172,5,109,919000,930000,11000
998172,6,138,930000,956000,26000
998172,7,126,956000,980000,24000
998172,8,117,980000,997000,17000
998172,9,129,997000,1014000,17000
998172,10,120,1014000,1022000,8000
998172,11,145,1022000,1042000,20000
998172,12,130,1042000,1058000,16000
998172,13,129,1058000,1069000,11000
998172,14,147,1069000,1096000,27000
998172,15,NA,1096000,1096000,0
998172,16,80,1096000,1075000,-21000
998172,17,97,1075000,1037000,-38000
998172,18,111,1037000,1004000,-33000
998172,19,116,1004000,981000,-23000
998172,20,77,981000,940000,-41000
998172,21,99,940000,912000,-28000
998172,22,100,912000,890000,-22000
998172,23,89,890000,865000,-25000
998172,24,71,865000,825000,-40000
998180,1,15,352000,333000,-19000
998180,2,66,333000,340000,7000
998180,3,NA,340000,340000,0
998180,4,54,340000,355000,15000
998180,5,58,355000,377000,22000
998180,6,44,377000,392000,15000
998180,7,24,392000,386000,-6000
998180,8,76,386000,400000,14000
998180,9,60,400000,417000,17000
998180,10,89,417000,455000,38000
998180,11,69,455000,491000,36000
998180,12,NA,491000,491000,0
998180,13,9,491000,478000,-13000
998180,14,23,478000,444000,-34000
998180,15,NA,444000,444000,0
998180,16,NA,444000,444000,0
998180,17,NA,444000,444000,0
998180,18,58,444000,423000,-21000
998180,19,NA,423000,423000,0
998180,20,NA,423000,423000,0
998180,21,NA,423000,423000,0
998180,22,NA,423000,423000,0
998180,23,20,423000,385000,-38000
998180,24,NA,385000,385000,0
998195,1,NA,428000,428000,0
998195,2,NA,428000,428000,0
998195,3,NA,428000,428000,0
998195,4,NA,428000,428000,0
998195,5,NA,428000,428000,0
998195,6,NA,428000,428000,0
998195,7,NA,428000,428000,0
998195,8,NA,428000,428000,0
998195,9,NA,428000,428000,0
998195,10,NA,428000,428000,0
998195,11,NA,428000,428000,0
998195,12,NA,428000,428000,0
998195,13,NA,428000,428000,0
998195,14,NA,428000,428000,0
998195,15,NA,428000,428000,0
998195,16,NA,428000,428000,0
998195,17,NA,428000,428000,0
998195,18,NA,428000,428000,0
998195,19,NA,428000,428000,0
998195,20,NA,428000,428000,0
998195,21,NA,428000,428000,0
998195,22,NA,428000,428000,0
998195,23,NA,428000,428000,0
998195,24,NA,428000,428000,0
998205,1,2,766000,702000,-64000
998205,2,NA,702000,702000,0
998205,3,NA,702000,702000,0
998205,4,NA,702000,702000,0
998205,5,NA,702000,702000,0
998205,6,79,702000,654000,-48000
998205,7,115,654000,650000,-4000
998205,8,78,650000,654000,4000
998205,9,61,654000,650000,-4000
998205,10,86,650000,659000,9000
998205,11,59,659000,648000,-11000
998205,12,55,648000,622000,-26000
998205,13,58,622000,595000,-27000
998205,14,84,595000,593000,-2000
998205,15,NA,593000,593000,0
998205,16,65,593000,588000,-5000
998205,17,87,588000,599000,11000
998205,18,83,599000,616000,17000
998205,19,74,616000,627000,11000
998205,20,79,627000,636000,9000
998205,21,58,636000,629000,-7000
998205,22,57,629000,610000,-19000
998205,23,103,610000,618000,8000
998205,24,57,618000,610000,-8000
998215,1,122,610000,648000,38000
998215,2,130,648000,717000,69000
998215,3,88,717000,765000,48000
998215,4,99,765000,799000,34000
998215,5,100,799000,821000,22000
998215,6,86,821000,821000,0
998215,7,54,821000,787000,-34000
998215,8,70,787000,750000,-37000
998215,9,98,750000,733000,-17000
998215,10,NA,733000,733000,0
998215,11,NA,733000,733000,0
998215,12,NA,733000,733000,0
998215,13,NA,733000,733000,0
998215,14,NA,733000,733000,0
998215,15,NA,733000,733000,0
998215,16,NA,733000,733000,0
998215,17,NA,733000,733000,0
998215,18,NA,733000,733000,0
998215,19,NA,733000,733000,0
998215,20,NA,733000,733000,0
998215,21,NA,733000,733000,0
998215,22,NA,733000,733000,0
998215,23,NA,733000,733000,0
998215,24,73,733000,709000,-24000
998260,1,NA,607000,607000,0
998260,2,77,607000,611000,4000
998260,3,80,611000,621000,10000
998260,4,82,621000,634000,13000
998260,5,49,634000,625000,-9000
998260,6,80,625000,624000,-1000
998260,7,10,624000,576000,-48000
998260,8,NA,576000,576000,0
998260,9,NA,576000,576000,0
998260,10,NA,576000,576000,0
998260,11,NA,576000,576000,0
998260,12,NA,576000,576000,0
998260,13,NA,576000,576000,0
998260,14,21,576000,514000,-62000
998260,15,54,514000,469000,-45000
998260,16,9,469000,412000,-57000
998260,17,101,412000,416000,4000
998260,18,78,416000,446000,30000
998260,19,78,446000,486000,40000
998260,20,28,486000,491000,5000
998260,21,56,491000,492000,1000
998260,22,62,492000,489000,-3000
998260,23,79,489000,499000,10000
998260,24,88,499000,524000,25000
998390,1,58,589000,582000,-7000
998390,2,58,582000,570000,-12000
998390,3,70,570000,565000,-5000
998390,4,46,565000,547000,-18000
998390,5,40,547000,520000,-27000
998390,6,65,520000,508000,-12000
998390,7,52,508000,495000,-13000
998390,8,NA,495000,495000,0
998390,9,63,495000,491000,-4000
998390,10,NA,491000,491000,0
998390,11,NA,491000,491000,0
998390,12,NA,491000,491000,0
998390,13,NA,491000,491000,0
998390,14,NA,491000,491000,0
998390,15,NA,491000,491000,0
998390,16,NA,491000,491000,0
998390,17,NA,491000,491000,0
998390,18,NA,491000,491000,0
998390,19,NA,491000,491000,0
998390,20,NA,491000,491000,0
998390,21,NA,491000,491000,0
998390,22,NA,491000,491000,0
998390,23,NA,491000,491000,0
998390,24,NA,491000,491000,0
998484,1,56,522000,519000,-3000
998484,2,76,519000,529000,10000
998484,3,91,529000,557000,28000
998484,4,82,557000,587000,30000
998484,5,25,587000,574000,-13000
998484,6,67,574000,565000,-9000
998484,7,72,565000,560000,-5000
998484,8,83,560000,568000,8000
998484,9,72,568000,577000,9000
998484,10,NA,577000,577000,0
998484,11,59,577000,580000,3000
998484,12,72,580000,582000,2000
998484,13,26,582000,552000,-30000
998484,14,67,552000,536000,-16000
998484,15,NA,536000,536000,0
998484,16,47,536000,513000,-23000
998484,17,87,513000,519000,6000
998484,18,50,519000,516000,-3000
998484,19,NA,516000,516000,0
998484,20,NA,516000,516000,0
998484,21,NA,516000,516000,0
998484,22,NA,516000,516000,0
998484,23,NA,516000,516000,0
998484,24,NA,516000,516000,0
998529,1,NA,429000,429000,0
998529,2,NA,429000,429000,0
998529,3,NA,429000,429000,0
998529,4,NA,429000,429000,0
998529,5,NA,429000,429000,0
998529,6,NA,429000,429000,0
998529,7,72,429000,444000,15000
998529,8,NA,444000,444000,0
998529,9,NA,444000,444000,0
998529,10,NA,444000,444000,0
998529,11,NA,444000,444000,0
998529,12,NA,444000,444000,0
998529,13,NA,444000,444000,0
998529,14,NA,444000,444000,0
998529,15,NA,444000,444000,0
998529,16,NA,444000,444000,0
998529,17,NA,444000,444000,0
998529,18,107,444000,493000,49000
998529,19,103,493000,557000,64000
998529,20,85,557000,611000,54000
998529,21,62,611000,633000,22000
998529,22,36,633000,614000,-19000
998529,23,76,614000,598000,-16000
998529,24,88,598000,595000,-3000
998647,1,59,520000,519000,-1000
998647,2,61,519000,520000,1000
998647,3,NA,520000,520000,0
998647,4,NA,520000,520000,0
998647,5,NA,520000,520000,0
998647,6,NA,520000,520000,0
998647,7,NA,520000,520000,0
998647,8,49,520000,510000,-10000
998647,9,129,510000,553000,43000
998647,10,64,553000,579000,26000
998647,11,47,579000,581000,2000
998647,12,94,581000,598000,17000
998647,13,53,598000,594000,-4000
998647,14,NA,594000,594000,0
998647,15,63,594000,583000,-11000
998647,16,46,583000,562000,-21000
998647,17,41,562000,531000,-31000
998647,18,76,531000,519000,-12000
998647,19,40,519000,499000,-20000
998647,20,14,499000,457000,-42000
998647,21,NA,457000,457000,0
998647,22,NA,457000,457000,0
998647,23,58,457000,435000,-22000
998647,24,56,435000,424000,-11000
998659,1,156,756000,807000,51000
998659,2,115,807000,860000,53000
998659,3,85,860000,883000,23000
998659,4,96,883000,889000,6000
998659,5,69,889000,863000,-26000
998659,6,119,863000,854000,-9000
998659,7,73,854000,829000,-25000
998659,8,102,829000,820000,-9000
998659,9,94,820000,814000,-6000
998659,10,83,814000,803000,-11000
998659,11,102,803000,799000,-4000
998659,12,NA,799000,799000,0
998659,13,81,799000,789000,-10000
998659,14,77,789000,775000,-14000
998659,15,143,775000,802000,27000
998659,16,88,802000,816000,14000
998659,17,142,816000,856000,40000
998659,18,90,856000,873000,17000
998659,19,98,873000,879000,6000
998659,20,112,879000,884000,5000
998659,21,76,884000,866000,-18000
998659,22,78,866000,834000,-32000
998659,23,122,834000,831000,-3000
998659,24,86,831000,819000,-12000
998782,1,NA,396000,396000,0
998782,2,NA,396000,396000,0
998782,3,NA,396000,396000,0
998782,4,NA,396000,396000,0
998782,5,NA,396000,396000,0
998782,6,NA,396000,396000,0
998782,7,NA,396000,396000,0
998782,8,NA,396000,396000,0
998782,9,NA,396000,396000,0
998782,10,NA,396000,396000,0
998782,11,NA,396000,396000,0
998782,12,NA,396000,396000,0
998782,13,NA,396000,396000,0
998782,14,NA,396000,396000,0
998782,15,NA,396000,396000,0
998782,16,NA,396000,396000,0
998782,17,NA,396000,396000,0
998782,18,NA,396000,396000,0
998782,19,15,396000,373000,-23000
998782,20,NA,373000,373000,0
998782,21,NA,373000,373000,0
998782,22,NA,373000,373000,0
998782,23,NA,373000,373000,0
998782,24,NA,373000,373000,0
998791,1,67,566000,567000,1000
998791,2,79,567000,578000,11000
998791,3,58,578000,579000,1000
998791,4,83,579000,590000,11000
998791,5,87,590000,610000,20000
998791,6,77,610000,627000,17000
998791,7,70,627000,633000,6000
998791,8,102,633000,657000,24000
998791,9,21,657000,629000,-28000
998791,10,48,629000,591000,-38000
998791,11,NA,591000,591000,0
998791,12,NA,591000,591000,0
998791,13,NA,591000,591000,0
998791,14,NA,591000,591000,0
998791,15,NA,591000,591000,0
998791,16,NA,591000,591000,0
998791,17,NA,591000,591000,0
998791,18,NA,591000,591000,0
998791,19,NA,591000,591000,0
998791,20,NA,591000,591000,0
998791,21,NA,591000,591000,0
998791,22,66,591000,563000,-28000
998791,23,54,563000,538000,-25000
998791,24,54,538000,513000,-25000
999309,1,NA,666000,666000,0
999309,2,NA,666000,666000,0
999309,3,NA,666000,666000,0
999309,4,NA,666000,666000,0
999309,5,NA,666000,666000,0
999309,6,NA,666000,666000,0
999309,7,NA,666000,666000,0
999309,8,NA,666000,666000,0
999309,9,NA,666000,666000,0
999309,10,NA,666000,666000,0
999309,11,NA,666000,666000,0
999309,12,NA,666000,666000,0
999309,13,NA,666000,666000,0
999309,14,NA,666000,666000,0
999309,15,NA,666000,666000,0
999309,16,NA,666000,666000,0
999309,17,NA,666000,666000,0
999309,18,NA,666000,666000,0
999309,19,8,666000,615000,-51000
999309,20,NA,615000,615000,0
999309,21,NA,615000,615000,0
999309,22,NA,615000,615000,0
999309,23,NA,615000,615000,0
999309,24,NA,615000,615000,0
999321,1,67,503000,510000,7000
999321,2,64,510000,518000,8000
999321,3,63,518000,526000,8000
999321,4,NA,526000,526000,0
999321,5,39,526000,514000,-12000
999321,6,72,514000,515000,1000
999321,7,NA,515000,515000,0
999321,8,76,515000,525000,10000
999321,9,56,525000,527000,2000
999321,10,77,527000,539000,12000
999321,11,53,539000,541000,2000
999321,12,NA,541000,541000,0
999321,13,32,541000,516000,-25000
999321,14,NA,516000,516000,0
999321,15,58,516000,499000,-17000
999321,16,44,499000,478000,-21000
999321,17,34,478000,448000,-30000
999321,18,NA,448000,448000,0
999321,19,63,448000,439000,-9000
999321,20,52,439000,436000,-3000
999321,21,66,436000,445000,9000
999321,22,48,445000,449000,4000
999321,23,62,449000,458000,9000
999321,24,78,458000,477000,19000
999326,1,50,622000,606000,-16000
999326,2,32,606000,567000,-39000
999326,3,41,567000,522000,-45000
999326,4,70,522000,502000,-20000
999326,5,78,502000,506000,4000
999326,6,74,506000,524000,18000
999326,7,70,524000,545000,21000
999326,8,37,545000,538000,-7000
999326,9,NA,538000,538000,0
999326,10,30,538000,507000,-31000
999326,11,51,507000,479000,-28000
999326,12,67,479000,467000,-12000
999326,13,NA,467000,467000,0
999326,14,49,467000,460000,-7000
999326,15,82,460000,479000,19000
999326,16,48,479000,487000,8000
999326,17,91,487000,515000,28000
999326,18,76,515000,541000,26000
999326,19,61,541000,555000,14000
999326,20,71,555000,565000,10000
999326,21,22,565000,539000,-26000
999326,22,57,539000,514000,-25000
999326,23,16,514000,466000,-48000
999326,24,NA,466000,466000,0
999331,1,57,500000,500000,0
999331,2,77,500000,514000,14000
999331,3,NA,514000,514000,0
999331,4,NA,514000,514000,0
999331,5,109,514000,558000,44000
999331,6,73,558000,592000,34000
999331,7,32,592000,585000,-7000
999331,8,49,585000,565000,-20000
999331,9,50,565000,537000,-28000
999331,10,34,537000,494000,-43000
999331,11,49,494000,464000,-30000
999331,12,72,464000,461000,-3000
999331,13,72,461000,474000,13000
999331,14,NA,474000,474000,0
999331,15,57,474000,486000,12000
999331,16,83,486000,514000,28000
999331,17,38,514000,514000,0
999331,18,54,514000,506000,-8000
999331,19,43,506000,487000,-19000
999331,20,86,487000,495000,8000
999331,21,121,495000,544000,49000
999331,22,43,544000,562000,18000
999331,23,28,562000,546000,-16000
999331,24,41,546000,516000,-30000
999391,1,64,554000,554000,0
999391,2,64,554000,554000,0
999391,3,56,554000,548000,-6000
999391,4,67,548000,546000,-2000
999391,5,35,546000,524000,-22000
999391,6,70,524000,518000,-6000
999391,7,89,518000,534000,16000
999391,8,79,534000,557000,23000
999391,9,63,557000,570000,13000
999391,10,NA,570000,570000,0
999391,11,92,570000,597000,27000
999391,12,46,597000,592000,-5000
999391,13,72,592000,588000,-4000
999391,14,NA,588000,588000,0
999391,15,77,588000,591000,3000
999391,16,85,591000,604000,13000
999391,17,78,604000,616000,12000
999391,18,57,616000,614000,-2000
999391,19,50,614000,595000,-19000
999391,20,NA,595000,595000,0
999391,21,71,595000,582000,-13000
999391,22,63,582000,568000,-14000
999391,23,80,568000,569000,1000
999391,24,41,569000,552000,-17000
999715,1,67,455000,466000,11000
999715,2,NA,466000,466000,0
999715,3,55,466000,474000,8000
999715,4,NA,474000,474000,0
999715,5,NA,474000,474000,0
999715,6,NA,474000,474000,0
999715,7,NA,474000,474000,0
999715,8,NA,474000,474000,0
999715,9,NA,474000,474000,0
999715,10,NA,474000,474000,0
999715,11,22,474000,453000,-21000
999715,12,31,453000,423000,-30000
999715,13,NA,423000,423000,0
999715,14,NA,423000,423000,0
999715,15,NA,423000,423000,0
999715,16,NA,423000,423000,0
999715,17,21,423000,384000,-39000
999715,18,NA,384000,384000,0
999715,19,17,384000,338000,-46000
999715,20,15,338000,294000,-44000
999715,21,65,294000,292000,-2000
999715,22,39,292000,297000,5000
999715,23,NA,297000,297000,0
999715,24,NA,297000,297000,0
999824,1,NA,432000,432000,0
999824,2,NA,432000,432000,0
999824,3,NA,432000,432000,0
999824,4,NA,432000,432000,0
999824,5,NA,432000,432000,0
999824,6,NA,432000,432000,0
999824,7,NA,432000,432000,0
999824,8,NA,432000,432000,0
999824,9,NA,432000,432000,0
999824,10,NA,432000,432000,0
999824,11,NA,432000,432000,0
999824,12,NA,432000,432000,0
999824,13,NA,432000,432000,0
999824,14,53,432000,435000,3000
999824,15,NA,435000,435000,0
999824,16,51,435000,436000,1000
999824,17,32,436000,423000,-13000
999824,18,NA,423000,423000,0
999824,19,NA,423000,423000,0
999824,20,NA,423000,423000,0
999824,21,NA,423000,423000,0
999824,22,NA,423000,423000,0
999824,23,NA,423000,423000,0
999824,24,NA,423000,423000,0
999827,1,28,622000,590000,-32000
999827,2,79,590000,574000,-16000
999827,3,42,574000,547000,-27000
999827,4,78,547000,541000,-6000
999827,5,43,541000,526000,-15000
999827,6,81,526000,534000,8000
999827,7,86,534000,555000,21000
999827,8,NA,555000,555000,0
999827,9,NA,555000,555000,0
999827,10,NA,555000,555000,0
999827,11,NA,555000,555000,0
999827,12,47,555000,555000,0
999827,13,NA,555000,555000,0
999827,14,NA,555000,555000,0
999827,15,NA,555000,555000,0
999827,16,NA,555000,555000,0
999827,17,NA,555000,555000,0
999827,18,NA,555000,555000,0
999827,19,NA,555000,555000,0
999827,20,NA,555000,555000,0
999827,21,108,555000,584000,29000
999827,22,63,584000,598000,14000
999827,23,103,598000,626000,28000
999827,24,70,626000,637000,11000
1000061,1,NA,468000,468000,0
1000061,2,NA,468000,468000,0
1000061,3,NA,468000,468000,0
1000061,4,NA,468000,468000,0
1000061,5,NA,468000,468000,0
1000061,6,NA,468000,468000,0
1000061,7,19,468000,441000,-27000
1000061,8,NA,441000,441000,0
1000061,9,NA,441000,441000,0
1000061,10,105,441000,459000,18000
1000061,11,38,459000,461000,2000
1000061,12,66,461000,471000,10000
1000061,13,69,471000,487000,16000
1000061,14,38,487000,486000,-1000
1000061,15,NA,486000,486000,0
1000061,16,50,486000,476000,-10000
1000061,17,33,476000,453000,-23000
1000061,18,35,453000,424000,-29000
1000061,19,NA,424000,424000,0
1000061,20,NA,424000,424000,0
1000061,21,NA,424000,424000,0
1000061,22,NA,424000,424000,0
1000061,23,NA,424000,424000,0
1000061,24,NA,424000,424000,0
1000068,1,NA,374000,374000,0
1000068,2,NA,374000,374000,0
1000068,3,NA,374000,374000,0
1000068,4,NA,374000,374000,0
1000068,5,NA,374000,374000,0
1000068,6,NA,374000,374000,0
1000068,7,NA,374000,374000,0
1000068,8,NA,374000,374000,0
1000068,9,NA,374000,374000,0
1000068,10,NA,374000,374000,0
1000068,11,NA,374000,374000,0
1000068,12,NA,374000,374000,0
1000068,13,NA,374000,374000,0
1000068,14,NA,374000,374000,0
1000068,15,NA,374000,374000,0
1000068,16,NA,374000,374000,0
1000068,17,NA,374000,374000,0
1000068,18,NA,374000,374000,0
1000068,19,NA,374000,374000,0
1000068,20,NA,374000,374000,0
1000068,21,NA,374000,374000,0
1000068,22,NA,374000,374000,0
1000068,23,NA,374000,374000,0
1000068,24,22,374000,356000,-18000
1000072,1,105,604000,630000,26000
1000072,2,77,630000,652000,22000
1000072,3,55,652000,651000,-1000
1000072,4,79,651000,650000,-1000
1000072,5,89,650000,658000,8000
1000072,6,91,658000,671000,13000
1000072,7,100,671000,695000,24000
1000072,8,80,695000,711000,16000
1000072,9,103,711000,733000,22000
1000072,10,103,733000,755000,22000
1000072,11,69,755000,753000,-2000
1000072,12,63,753000,731000,-22000
1000072,13,73,731000,707000,-24000
1000072,14,NA,707000,707000,0
1000072,15,75,707000,686000,-21000
1000072,16,113,686000,696000,10000
1000072,17,113,696000,727000,31000
1000072,18,80,727000,745000,18000
1000072,19,47,745000,726000,-19000
1000072,20,93,726000,718000,-8000
1000072,21,51,718000,685000,-33000
1000072,22,64,685000,650000,-35000
1000072,23,60,650000,620000,-30000
1000072,24,79,620000,605000,-15000
1000223,1,55,616000,604000,-12000
1000223,2,100,604000,618000,14000
1000223,3,110,618000,656000,38000
1000223,4,79,656000,681000,25000
1000223,5,122,681000,728000,47000
1000223,6,53,728000,734000,6000
1000223,7,60,734000,714000,-20000
1000223,8,94,714000,705000,-9000
1000223,9,80,705000,697000,-8000
1000223,10,55,697000,670000,-27000
1000223,11,59,670000,644000,-26000
1000223,12,86,644000,635000,-9000
1000223,13,57,635000,616000,-19000
1000223,14,59,616000,599000,-17000
1000223,15,NA,599000,599000,0
1000223,16,49,599000,575000,-24000
1000223,17,54,575000,550000,-25000
1000223,18,59,550000,530000,-20000
1000223,19,79,530000,531000,1000
1000223,20,64,531000,535000,4000
1000223,21,71,535000,544000,9000
1000223,22,72,544000,556000,12000
1000223,23,54,556000,554000,-2000
1000223,24,35,554000,527000,-27000
1000860,1,71,573000,577000,4000
1000860,2,50,577000,567000,-10000
1000860,3,90,567000,578000,11000
1000860,4,81,578000,595000,17000
1000860,5,104,595000,631000,36000
1000860,6,49,631000,636000,5000
1000860,7,42,636000,615000,-21000
1000860,8,50,615000,583000,-32000
1000860,9,90,583000,576000,-7000
1000860,10,114,576000,603000,27000
1000860,11,68,603000,623000,20000
1000860,12,NA,623000,623000,0
1000860,13,68,623000,633000,10000
1000860,14,77,633000,644000,11000
1000860,15,70,644000,641000,-3000
1000860,16,88,641000,645000,4000
1000860,17,84,645000,654000,9000
1000860,18,62,654000,649000,-5000
1000860,19,101,649000,663000,14000
1000860,20,89,663000,679000,16000
1000860,21,64,679000,676000,-3000
1000860,22,112,676000,696000,20000
1000860,23,100,696000,721000,25000
1000860,24,82,721000,729000,8000
1000864,1,77,605000,610000,5000
1000864,2,90,610000,629000,19000
1000864,3,29,629000,609000,-20000
1000864,4,NA,609000,609000,0
1000864,5,NA,609000,609000,0
1000864,6,NA,609000,609000,0
1000864,7,NA,609000,609000,0
1000864,8,33,609000,567000,-42000
1000864,9,52,567000,529000,-38000
1000864,10,96,529000,529000,0
1000864,11,81,529000,543000,14000
1000864,12,66,543000,559000,16000
1000864,13,39,559000,552000,-7000
1000864,14,NA,552000,552000,0
1000864,15,74,552000,553000,1000
1000864,16,NA,553000,553000,0
1000864,17,NA,553000,553000,0
1000864,18,NA,553000,553000,0
1000864,19,NA,553000,553000,0
1000864,20,47,553000,536000,-17000
1000864,21,NA,536000,536000,0
1000864,22,NA,536000,536000,0
1000864,23,NA,536000,536000,0
1000864,24,NA,536000,536000,0
1000887,1,NA,560000,560000,0
1000887,2,NA,560000,560000,0
1000887,3,NA,560000,560000,0
1000887,4,NA,560000,560000,0
1000887,5,NA,560000,560000,0
1000887,6,NA,560000,560000,0
1000887,7,94,560000,579000,19000
1000887,8,69,579000,594000,15000
1000887,9,31,594000,576000,-18000
1000887,10,126,576000,604000,28000
1000887,11,64,604000,615000,11000
1000887,12,96,615000,636000,21000
1000887,13,83,636000,656000,20000
1000887,14,NA,656000,656000,0
1000887,15,62,656000,660000,4000
1000887,16,53,660000,640000,-20000
1000887,17,43,640000,603000,-37000
1000887,18,54,603000,566000,-37000
1000887,19,99,566000,566000,0
1000887,20,49,566000,557000,-9000
1000887,21,98,557000,577000,20000
1000887,22,57,577000,584000,7000
1000887,23,NA,584000,584000,0
1000887,24,NA,584000,584000,0
1000932,1,79,523000,537000,14000
1000932,2,59,537000,545000,8000
1000932,3,32,545000,527000,-18000
1000932,4,63,527000,515000,-12000
1000932,5,101,515000,537000,22000
1000932,6,39,537000,534000,-3000
1000932,7,83,534000,547000,13000
1000932,8,62,547000,556000,9000
1000932,9,57,556000,554000,-2000
1000932,10,NA,554000,554000,0
1000932,11,34,554000,526000,-28000
1000932,12,2,526000,468000,-58000
1000932,13,NA,468000,468000,0
1000932,14,NA,468000,468000,0
1000932,15,NA,468000,468000,0
1000932,16,NA,468000,468000,0
1000932,17,NA,468000,468000,0
1000932,18,NA,468000,468000,0
1000932,19,NA,468000,468000,0
1000932,20,NA,468000,468000,0
1000932,21,NA,468000,468000,0
1000932,22,NA,468000,468000,0
1000932,23,NA,468000,468000,0
1000932,24,NA,468000,468000,0
1000937,1,NA,444000,444000,0
1000937,2,NA,444000,444000,0
1000937,3,NA,444000,444000,0
1000937,4,NA,444000,444000,0
1000937,5,NA,444000,444000,0
1000937,6,NA,444000,444000,0
1000937,7,NA,444000,444000,0
1000937,8,NA,444000,444000,0
1000937,9,NA,444000,444000,0
1000937,10,66,444000,452000,8000
1000937,11,47,452000,454000,2000
1000937,12,37,454000,443000,-11000
1000937,13,NA,443000,443000,0
1000937,14,55,443000,440000,-3000
1000937,15,66,440000,447000,7000
1000937,16,54,447000,452000,5000
1000937,17,52,452000,455000,3000
1000937,18,72,455000,470000,15000
1000937,19,44,470000,470000,0
1000937,20,43,470000,460000,-10000
1000937,21,9,460000,422000,-38000
1000937,22,NA,422000,422000,0
1000937,23,NA,422000,422000,0
1000937,24,NA,422000,422000,0
1000953,1,76,628000,631000,3000
1000953,2,61,631000,624000,-7000
1000953,3,32,624000,590000,-34000
1000953,4,119,590000,604000,14000
1000953,5,55,604000,603000,-1000
1000953,6,110,603000,632000,29000
1000953,7,72,632000,650000,18000
1000953,8,42,650000,638000,-12000
1000953,9,87,638000,634000,-4000
1000953,10,60,634000,620000,-14000
1000953,11,41,620000,586000,-34000
1000953,12,86,586000,579000,-7000
1000953,13,56,579000,568000,-11000
1000953,14,74,568000,569000,1000
1000953,15,NA,569000,569000,0
1000953,16,118,569000,606000,37000
1000953,17,118,606000,664000,58000
1000953,18,13,664000,652000,-12000
1000953,19,NA,652000,652000,0
1000953,20,NA,652000,652000,0
1000953,21,NA,652000,652000,0
1000953,22,NA,652000,652000,0
1000953,23,39,652000,617000,-35000
1000953,24,64,617000,582000,-35000
1000960,1,NA,496000,496000,0
1000960,2,NA,496000,496000,0
1000960,3,NA,496000,496000,0
1000960,4,NA,496000,496000,0
1000960,5,NA,496000,496000,0
1000960,6,17,496000,466000,-30000
1000960,7,NA,466000,466000,0
1000960,8,NA,466000,466000,0
1000960,9,NA,466000,466000,0
1000960,10,NA,466000,466000,0
1000960,11,NA,466000,466000,0
1000960,12,NA,466000,466000,0
1000960,13,NA,466000,466000,0
1000960,14,NA,466000,466000,0
1000960,15,NA,466000,466000,0
1000960,16,NA,466000,466000,0
1000960,17,NA,466000,466000,0
1000960,18,NA,466000,466000,0
1000960,19,NA,466000,466000,0
1000960,20,NA,466000,466000,0
1000960,21,NA,466000,466000,0
1000960,22,NA,466000,466000,0
1000960,23,NA,466000,466000,0
1000960,24,NA,466000,466000,0
1000963,1,NA,723000,723000,0
1000963,2,NA,723000,723000,0
1000963,3,96,723000,730000,7000
1000963,4,60,730000,717000,-13000
1000963,5,68,717000,697000,-20000
1000963,6,87,697000,690000,-7000
1000963,7,78,690000,682000,-8000
1000963,8,102,682000,694000,12000
1000963,9,55,694000,685000,-9000
1000963,10,NA,685000,685000,0
1000963,11,NA,685000,685000,0
1000963,12,NA,685000,685000,0
1000963,13,NA,685000,685000,0
1000963,14,NA,685000,685000,0
1000963,15,NA,685000,685000,0
1000963,16,91,685000,688000,3000
1000963,17,14,688000,640000,-48000
1000963,18,NA,640000,640000,0
1000963,19,NA,640000,640000,0
1000963,20,NA,640000,640000,0
1000963,21,90,640000,619000,-21000
1000963,22,89,619000,616000,-3000
1000963,23,94,616000,632000,16000
1000963,24,70,632000,638000,6000
1000972,1,64,657000,648000,-9000
1000972,2,63,648000,633000,-15000
1000972,3,89,633000,635000,2000
1000972,4,47,635000,616000,-19000
1000972,5,48,616000,589000,-27000
1000972,6,123,589000,613000,24000
1000972,7,67,613000,624000,11000
1000972,8,102,624000,652000,28000
1000972,9,77,652000,672000,20000
1000972,10,106,672000,702000,30000
1000972,11,50,702000,692000,-10000
1000972,12,78,692000,682000,-10000
1000972,13,59,682000,658000,-24000
1000972,14,55,658000,631000,-27000
1000972,15,NA,631000,631000,0
1000972,16,79,631000,615000,-16000
1000972,17,70,615000,606000,-9000
1000972,18,92,606000,616000,10000
1000972,19,117,616000,656000,40000
1000972,20,80,656000,683000,27000
1000972,21,67,683000,690000,7000
1000972,22,77,690000,688000,-2000
1000972,23,61,688000,669000,-19000
1000972,24,98,669000,664000,-5000
1000978,1,55,909000,872000,-37000
1000978,2,69,872000,822000,-50000
1000978,3,71,822000,772000,-50000
1000978,4,78,772000,733000,-39000
1000978,5,75,733000,706000,-27000
1000978,6,94,706000,704000,-2000
1000978,7,76,704000,700000,-4000
1000978,8,92,700000,707000,7000
1000978,9,86,707000,713000,6000
1000978,10,128,713000,747000,34000
1000978,11,58,747000,747000,0
1000978,12,NA,747000,747000,0
1000978,13,81,747000,740000,-7000
1000978,14,NA,740000,740000,0
1000978,15,89,740000,737000,-3000
1000978,16,116,737000,755000,18000
1000978,17,118,755000,784000,29000
1000978,18,104,784000,813000,29000
1000978,19,90,813000,827000,14000
1000978,20,115,827000,845000,18000
1000978,21,89,845000,845000,0
1000978,22,120,845000,856000,11000
1000978,23,77,856000,845000,-11000
1000978,24,84,845000,824000,-21000
1000980,1,49,473000,469000,-4000
1000980,2,83,469000,487000,18000
1000980,3,36,487000,485000,-2000
1000980,4,41,485000,471000,-14000
1000980,5,60,471000,466000,-5000
1000980,6,NA,466000,466000,0
1000980,7,NA,466000,466000,0
1000980,8,75,466000,477000,11000
1000980,9,84,477000,502000,25000
1000980,10,95,502000,546000,44000
1000980,11,60,546000,571000,25000
1000980,12,26,571000,554000,-17000
1000980,13,73,554000,545000,-9000
1000980,14,NA,545000,545000,0
1000980,15,13,545000,501000,-44000
1000980,16,73,501000,482000,-19000
1000980,17,NA,482000,482000,0
1000980,18,46,482000,464000,-18000
1000980,19,NA,464000,464000,0
1000980,20,89,464000,482000,18000
1000980,21,NA,482000,482000,0
1000980,22,NA,482000,482000,0
1000980,23,NA,482000,482000,0
1000980,24,47,482000,484000,2000
1000981,1,108,694000,715000,21000
1000981,2,89,715000,735000,20000
1000981,3,97,735000,756000,21000
1000981,4,105,756000,780000,24000
1000981,5,85,780000,789000,9000
1000981,6,73,789000,779000,-10000
1000981,7,72,779000,757000,-22000
1000981,8,88,757000,741000,-16000
1000981,9,102,741000,742000,1000
1000981,10,114,742000,762000,20000
1000981,11,88,762000,776000,14000
1000981,12,76,776000,774000,-2000
1000981,13,80,774000,762000,-12000
1000981,14,70,762000,743000,-19000
1000981,15,NA,743000,743000,0
1000981,16,85,743000,726000,-17000
1000981,17,64,726000,700000,-26000
1000981,18,97,700000,696000,-4000
1000981,19,83,696000,696000,0
1000981,20,78,696000,694000,-2000
1000981,21,51,694000,672000,-22000
1000981,22,63,672000,646000,-26000
1000981,23,48,646000,608000,-38000
1000981,24,31,608000,554000,-54000
1000998,1,NA,476000,476000,0
1000998,2,47,476000,470000,-6000
1000998,3,69,470000,476000,6000
1000998,4,45,476000,472000,-4000
1000998,5,68,472000,480000,8000
1000998,6,54,480000,484000,4000
1000998,7,64,484000,491000,7000
1000998,8,69,491000,503000,12000
1000998,9,107,503000,545000,42000
1000998,10,46,545000,556000,11000
1000998,11,55,556000,556000,0
1000998,12,73,556000,558000,2000
1000998,13,81,558000,567000,9000
1000998,14,NA,567000,567000,0
1000998,15,32,567000,547000,-20000
1000998,16,64,547000,537000,-10000
1000998,17,24,537000,503000,-34000
1000998,18,67,503000,485000,-18000
1000998,19,55,485000,473000,-12000
1000998,20,66,473000,476000,3000
1000998,21,91,476000,503000,27000
1000998,22,63,503000,525000,22000
1000998,23,70,525000,543000,18000
1000998,24,64,543000,550000,7000
1001017,1,76,451000,469000,18000
1001017,2,61,469000,487000,18000
1001017,3,28,487000,477000,-10000
1001017,4,25,477000,447000,-30000
1001017,5,21,447000,405000,-42000
1001017,6,29,405000,364000,-41000
1001017,7,47,364000,343000,-21000
1001017,8,51,343000,342000,-1000
1001017,9,71,342000,367000,25000
1001017,10,70,367000,404000,37000
1001017,11,88,404000,456000,52000
1001017,12,70,456000,498000,42000
1001017,13,67,498000,526000,28000
1001017,14,63,526000,544000,18000
1001017,15,NA,544000,544000,0
1001017,16,57,544000,545000,1000
1001017,17,62,545000,540000,-5000
1001017,18,34,540000,515000,-25000
1001017,19,49,515000,491000,-24000
1001017,20,49,491000,470000,-21000
1001017,21,43,470000,449000,-21000
1001017,22,65,449000,446000,-3000
1001017,23,92,446000,474000,28000
1001017,24,162,474000,565000,91000
1001024,1,34,522000,503000,-19000
1001024,2,24,503000,464000,-39000
1001024,3,56,464000,439000,-25000
1001024,4,44,439000,420000,-19000
1001024,5,86,420000,438000,18000
1001024,6,73,438000,469000,31000
1001024,7,108,469000,528000,59000
1001024,8,43,528000,551000,23000
1001024,9,NA,551000,551000,0
1001024,10,56,551000,555000,4000
1001024,11,50,555000,542000,-13000
1001024,12,71,542000,535000,-7000
1001024,13,50,535000,519000,-16000
1001024,14,NA,519000,519000,0
1001024,15,37,519000,496000,-23000
1001024,16,63,496000,487000,-9000
1001024,17,62,487000,484000,-3000
1001024,18,50,484000,477000,-7000
1001024,19,67,477000,482000,5000
1001024,20,NA,482000,482000,0
1001024,21,95,482000,514000,32000
1001024,22,104,514000,562000,48000
1001024,23,66,562000,592000,30000
1001024,24,40,592000,586000,-6000
1001026,1,87,669000,676000,7000
1001026,2,64,676000,671000,-5000
1001026,3,102,671000,685000,14000
1001026,4,82,685000,695000,10000
1001026,5,83,695000,703000,8000
1001026,6,64,703000,694000,-9000
1001026,7,66,694000,678000,-16000
1001026,8,14,678000,618000,-60000
1001026,9,NA,618000,618000,0
1001026,10,127,618000,618000,0
1001026,11,95,618000,636000,18000
1001026,12,86,636000,658000,22000
1001026,13,86,658000,679000,21000
1001026,14,NA,679000,679000,0
1001026,15,100,679000,711000,32000
1001026,16,52,711000,702000,-9000
1001026,17,63,702000,679000,-23000
1001026,18,75,679000,659000,-20000
1001026,19,128,659000,682000,23000
1001026,20,NA,682000,682000,0
1001026,21,NA,682000,682000,0
1001026,22,NA,682000,682000,0
1001026,23,NA,682000,682000,0
1001026,24,NA,682000,682000,0
1001028,1,29,615000,584000,-31000
1001028,2,51,584000,550000,-34000
1001028,3,89,550000,546000,-4000
1001028,4,83,546000,559000,13000
1001028,5,52,559000,561000,2000
1001028,6,67,561000,568000,7000
1001028,7,91,568000,588000,20000
1001028,8,64,588000,593000,5000
1001028,9,59,593000,588000,-5000
1001028,10,66,588000,583000,-5000
1001028,11,NA,583000,583000,0
1001028,12,20,583000,544000,-39000
1001028,13,51,544000,508000,-36000
1001028,14,NA,508000,508000,0
1001028,15,NA,508000,508000,0
1001028,16,87,508000,507000,-1000
1001028,17,71,507000,516000,9000
1001028,18,110,516000,559000,43000
1001028,19,24,559000,559000,0
1001028,20,NA,559000,559000,0
1001028,21,NA,559000,559000,0
1001028,22,NA,559000,559000,0
1001028,23,NA,559000,559000,0
1001028,24,NA,559000,559000,0
1001195,1,87,523000,543000,20000
1001195,2,54,543000,551000,8000
1001195,3,104,551000,585000,34000
1001195,4,92,585000,622000,37000
1001195,5,62,622000,637000,15000
1001195,6,67,637000,639000,2000
1001195,7,67,639000,632000,-7000
1001195,8,95,632000,640000,8000
1001195,9,89,640000,653000,13000
1001195,10,39,653000,636000,-17000
1001195,11,78,636000,628000,-8000
1001195,12,37,628000,595000,-33000
1001195,13,83,595000,581000,-14000
1001195,14,NA,581000,581000,0
1001195,15,100,581000,597000,16000
1001195,16,95,597000,629000,32000
1001195,17,69,629000,645000,16000
1001195,18,53,645000,640000,-5000
1001195,19,100,640000,650000,10000
1001195,20,NA,650000,650000,0
1001195,21,NA,650000,650000,0
1001195,22,NA,650000,650000,0
1001195,23,74,650000,650000,0
1001195,24,39,650000,621000,-29000
1001299,1,95,780000,784000,4000
1001299,2,81,784000,780000,-4000
1001299,3,113,780000,793000,13000
1001299,4,69,793000,784000,-9000
1001299,5,108,784000,791000,7000
1001299,6,133,791000,825000,34000
1001299,7,84,825000,836000,11000
1001299,8,96,836000,841000,5000
1001299,9,79,841000,830000,-11000
1001299,10,121,830000,835000,5000
1001299,11,102,835000,839000,4000
1001299,12,121,839000,858000,19000
1001299,13,106,858000,874000,16000
1001299,14,106,874000,891000,17000
1001299,15,NA,891000,891000,0
1001299,16,145,891000,926000,35000
1001299,17,103,926000,941000,15000
1001299,18,111,941000,948000,7000
1001299,19,108,948000,948000,0
1001299,20,106,948000,943000,-5000
1001299,21,109,943000,935000,-8000
1001299,22,112,935000,931000,-4000
1001299,23,89,931000,914000,-17000
1001299,24,138,914000,921000,7000
1001396,1,65,802000,782000,-20000
1001396,2,72,782000,754000,-28000
1001396,3,74,754000,726000,-28000
1001396,4,77,726000,703000,-23000
1001396,5,113,703000,714000,11000
1001396,6,55,714000,705000,-9000
1001396,7,59,705000,683000,-22000
1001396,8,64,683000,657000,-26000
1001396,9,NA,657000,657000,0
1001396,10,NA,657000,657000,0
1001396,11,NA,657000,657000,0
1001396,12,NA,657000,657000,0
1001396,13,NA,657000,657000,0
1001396,14,NA,657000,657000,0
1001396,15,NA,657000,657000,0
1001396,16,69,657000,635000,-22000
1001396,17,55,635000,606000,-29000
1001396,18,70,606000,590000,-16000
1001396,19,79,590000,589000,-1000
1001396,20,57,589000,581000,-8000
1001396,21,56,581000,568000,-13000
1001396,22,58,568000,554000,-14000
1001396,23,86,554000,559000,5000
1001396,24,52,559000,549000,-10000
1001398,1,91,831000,828000,-3000
1001398,2,97,828000,826000,-2000
1001398,3,NA,826000,826000,0
1001398,4,NA,826000,826000,0
1001398,5,54,826000,793000,-33000
1001398,6,86,793000,769000,-24000
1001398,7,35,769000,714000,-55000
1001398,8,61,714000,664000,-50000
1001398,9,95,664000,647000,-17000
1001398,10,78,647000,641000,-6000
1001398,11,66,641000,634000,-7000
1001398,12,64,634000,625000,-9000
1001398,13,78,625000,622000,-3000
1001398,14,93,622000,636000,14000
1001398,15,NA,636000,636000,0
1001398,16,60,636000,633000,-3000
1001398,17,86,633000,640000,7000
1001398,18,NA,640000,640000,0
1001398,19,NA,640000,640000,0
1001398,20,NA,640000,640000,0
1001398,21,NA,640000,640000,0
1001398,22,NA,640000,640000,0
1001398,23,NA,640000,640000,0
1001398,24,NA,640000,640000,0
1001438,1,NA,495000,495000,0
1001438,2,87,495000,516000,21000
1001438,3,60,516000,532000,16000
1001438,4,89,532000,561000,29000
1001438,5,63,561000,577000,16000
1001438,6,44,577000,569000,-8000
1001438,7,75,569000,566000,-3000
1001438,8,29,566000,537000,-29000
1001438,9,69,537000,521000,-16000
1001438,10,74,521000,522000,1000
1001438,11,61,522000,524000,2000
1001438,12,88,524000,544000,20000
1001438,13,62,544000,557000,13000
1001438,14,NA,557000,557000,0
1001438,15,45,557000,550000,-7000
1001438,16,4,550000,501000,-49000
1001438,17,NA,501000,501000,0
1001438,18,NA,501000,501000,0
1001438,19,NA,501000,501000,0
1001438,20,NA,501000,501000,0
1001438,21,NA,501000,501000,0
1001438,22,NA,501000,501000,0
1001438,23,NA,501000,501000,0
1001438,24,97,501000,493000,-8000
1001449,1,20,426000,405000,-21000
1001449,2,NA,405000,405000,0
1001449,3,NA,405000,405000,0
1001449,4,51,405000,391000,-14000
1001449,5,31,391000,372000,-19000
1001449,6,NA,372000,372000,0
1001449,7,NA,372000,372000,0
1001449,8,NA,372000,372000,0
1001449,9,NA,372000,372000,0
1001449,10,NA,372000,372000,0
1001449,11,8,372000,335000,-37000
1001449,12,NA,335000,335000,0
1001449,13,NA,335000,335000,0
1001449,14,70,335000,337000,2000
1001449,15,NA,337000,337000,0
1001449,16,40,337000,341000,4000
1001449,17,NA,341000,341000,0
1001449,18,NA,341000,341000,0
1001449,19,NA,341000,341000,0
1001449,20,NA,341000,341000,0
1001449,21,NA,341000,341000,0
1001449,22,NA,341000,341000,0
1001449,23,NA,341000,341000,0
1001449,24,NA,341000,341000,0
1002143,1,NA,385000,385000,0
1002143,2,NA,385000,385000,0
1002143,3,NA,385000,385000,0
1002143,4,NA,385000,385000,0
1002143,5,33,385000,376000,-9000
1002143,6,31,376000,360000,-16000
1002143,7,55,360000,359000,-1000
1002143,8,77,359000,384000,25000
1002143,9,42,384000,398000,14000
1002143,10,48,398000,409000,11000
1002143,11,19,409000,394000,-15000
1002143,12,75,394000,402000,8000
1002143,13,53,402000,408000,6000
1002143,14,76,408000,435000,27000
1002143,15,NA,435000,435000,0
1002143,16,68,435000,465000,30000
1002143,17,69,465000,493000,28000
1002143,18,48,493000,500000,7000
1002143,19,75,500000,514000,14000
1002143,20,55,514000,516000,2000
1002143,21,40,516000,501000,-15000
1002143,22,71,501000,498000,-3000
1002143,23,16,498000,467000,-31000
1002143,24,49,467000,441000,-26000
1002220,1,19,332000,318000,-14000
1002220,2,23,318000,297000,-21000
1002220,3,35,297000,284000,-13000
1002220,4,65,284000,300000,16000
1002220,5,82,300000,346000,46000
1002220,6,48,346000,383000,37000
1002220,7,22,383000,389000,6000
1002220,8,60,389000,400000,11000
1002220,9,48,400000,403000,3000
1002220,10,62,403000,411000,8000
1002220,11,32,411000,406000,-5000
1002220,12,NA,406000,406000,0
1002220,13,NA,406000,406000,0
1002220,14,NA,406000,406000,0
1002220,15,NA,406000,406000,0
1002220,16,18,406000,384000,-22000
1002220,17,31,384000,358000,-26000
1002220,18,NA,358000,358000,0
1002220,19,NA,358000,358000,0
1002220,20,NA,358000,358000,0
1002220,21,50,358000,346000,-12000
1002220,22,42,346000,340000,-6000
1002220,23,11,340000,318000,-22000
1002220,24,NA,318000,318000,0
1002222,1,96,463000,494000,31000
1002222,2,82,494000,536000,42000
1002222,3,57,536000,559000,23000
1002222,4,71,559000,575000,16000
1002222,5,114,575000,616000,41000
1002222,6,88,616000,650000,34000
1002222,7,103,650000,688000,38000
1002222,8,78,688000,711000,23000
1002222,9,85,711000,723000,12000
1002222,10,84,723000,724000,1000
1002222,11,76,724000,716000,-8000
1002222,12,82,716000,707000,-9000
1002222,13,80,707000,700000,-7000
1002222,14,NA,700000,700000,0
1002222,15,80,700000,696000,-4000
1002222,16,89,696000,699000,3000
1002222,17,77,699000,697000,-2000
1002222,18,127,697000,727000,30000
1002222,19,92,727000,750000,23000
1002222,20,88,750000,764000,14000
1002222,21,89,764000,770000,6000
1002222,22,83,770000,767000,-3000
1002222,23,71,767000,746000,-21000
1002222,24,92,746000,733000,-13000
1002227,1,51,526000,519000,-7000
1002227,2,31,519000,493000,-26000
1002227,3,90,493000,499000,6000
1002227,4,114,499000,544000,45000
1002227,5,65,544000,575000,31000
1002227,6,44,575000,580000,5000
1002227,7,46,580000,566000,-14000
1002227,8,85,566000,565000,-1000
1002227,9,99,565000,583000,18000
1002227,10,72,583000,599000,16000
1002227,11,49,599000,597000,-2000
1002227,12,NA,597000,597000,0
1002227,13,60,597000,587000,-10000
1002227,14,57,587000,572000,-15000
1002227,15,46,572000,544000,-28000
1002227,16,33,544000,506000,-38000
1002227,17,NA,506000,506000,0
1002227,18,NA,506000,506000,0
1002227,19,66,506000,488000,-18000
1002227,20,68,488000,486000,-2000
1002227,21,72,486000,497000,11000
1002227,22,75,497000,517000,20000
1002227,23,69,517000,537000,20000
1002227,24,45,537000,532000,-5000
1002228,1,NA,470000,470000,0
1002228,2,NA,470000,470000,0
1002228,3,NA,470000,470000,0
1002228,4,NA,470000,470000,0
1002228,5,NA,470000,470000,0
1002228,6,NA,470000,470000,0
1002228,7,NA,470000,470000,0
1002228,8,NA,470000,470000,0
1002228,9,NA,470000,470000,0
1002228,10,NA,470000,470000,0
1002228,11,NA,470000,470000,0
1002228,12,NA,470000,470000,0
1002228,13,NA,470000,470000,0
1002228,14,49,470000,467000,-3000
1002228,15,NA,467000,467000,0
1002228,16,87,467000,487000,20000
1002228,17,67,487000,507000,20000
1002228,18,70,507000,526000,19000
1002228,19,66,526000,540000,14000
1002228,20,41,540000,532000,-8000
1002228,21,26,532000,497000,-35000
1002228,22,85,497000,492000,-5000
1002228,23,NA,492000,492000,0
1002228,24,60,492000,489000,-3000
1002232,1,114,995000,995000,0
1002232,2,120,995000,998000,3000
1002232,3,90,998000,982000,-16000
1002232,4,108,982000,965000,-17000
1002232,5,72,965000,927000,-38000
1002232,6,99,927000,897000,-30000
1002232,7,113,897000,884000,-13000
1002232,8,157,884000,917000,33000
1002232,9,105,917000,938000,21000
1002232,10,135,938000,971000,33000
1002232,11,103,971000,982000,11000
1002232,12,NA,982000,982000,0
1002232,13,100,982000,972000,-10000
1002232,14,109,972000,963000,-9000
1002232,15,129,963000,967000,4000
1002232,16,102,967000,961000,-6000
1002232,17,97,961000,946000,-15000
1002232,18,110,946000,936000,-10000
1002232,19,91,936000,916000,-20000
1002232,20,122,916000,912000,-4000
1002232,21,106,912000,910000,-2000
1002232,22,101,910000,905000,-5000
1002232,23,119,905000,910000,5000
1002232,24,134,910000,929000,19000
1002235,1,63,570000,568000,-2000
1002235,2,55,568000,559000,-9000
1002235,3,65,559000,553000,-6000
1002235,4,99,553000,574000,21000
1002235,5,70,574000,590000,16000
1002235,6,65,590000,599000,9000
1002235,7,58,599000,595000,-4000
1002235,8,42,595000,571000,-24000
1002235,9,74,571000,557000,-14000
1002235,10,70,557000,552000,-5000
1002235,11,70,552000,554000,2000
1002235,12,NA,554000,554000,0
1002235,13,67,554000,558000,4000
1002235,14,63,558000,563000,5000
1002235,15,65,563000,563000,0
1002235,16,49,563000,550000,-13000
1002235,17,74,550000,547000,-3000
1002235,18,26,547000,518000,-29000
1002235,19,53,518000,494000,-24000
1002235,20,59,494000,481000,-13000
1002235,21,94,481000,500000,19000
1002235,22,46,500000,503000,3000
1002235,23,62,503000,510000,7000
1002235,24,76,510000,522000,12000
1002239,1,89,780000,779000,-1000
1002239,2,90,779000,779000,0
1002239,3,82,779000,773000,-6000
1002239,4,69,773000,752000,-21000
1002239,5,85,752000,739000,-13000
1002239,6,130,739000,763000,24000
1002239,7,137,763000,812000,49000
1002239,8,130,812000,870000,58000
1002239,9,62,870000,877000,7000
1002239,10,119,877000,889000,12000
1002239,11,90,889000,879000,-10000
1002239,12,111,879000,874000,-5000
1002239,13,82,874000,855000,-19000
1002239,14,122,855000,867000,12000
1002239,15,NA,867000,867000,0
1002239,16,114,867000,880000,13000
1002239,17,110,880000,892000,12000
1002239,18,62,892000,869000,-23000
1002239,19,NA,869000,869000,0
1002239,20,66,869000,828000,-41000
1002239,21,NA,828000,828000,0
1002239,22,NA,828000,828000,0
1002239,23,NA,828000,828000,0
1002239,24,86,828000,788000,-40000
1002240,1,47,631000,612000,-19000
1002240,2,51,612000,584000,-28000
1002240,3,41,584000,546000,-38000
1002240,4,69,546000,526000,-20000
1002240,5,67,526000,521000,-5000
1002240,6,64,521000,524000,3000
1002240,7,38,524000,511000,-13000
1002240,8,57,511000,501000,-10000
1002240,9,56,501000,492000,-9000
1002240,10,39,492000,472000,-20000
1002240,11,87,472000,482000,10000
1002240,12,54,482000,489000,7000
1002240,13,48,489000,486000,-3000
1002240,14,69,486000,495000,9000
1002240,15,NA,495000,495000,0
1002240,16,44,495000,490000,-5000
1002240,17,43,490000,473000,-17000
1002240,18,52,473000,460000,-13000
1002240,19,44,460000,446000,-14000
1002240,20,51,446000,435000,-11000
1002240,21,38,435000,421000,-14000
1002240,22,66,421000,424000,3000
1002240,23,NA,424000,424000,0
1002240,24,NA,424000,424000,0
1002242,1,87,332000,368000,36000
1002242,2,81,368000,422000,54000
1002242,3,NA,422000,422000,0
1002242,4,NA,422000,422000,0
1002242,5,NA,422000,422000,0
1002242,6,NA,422000,422000,0
1002242,7,NA,422000,422000,0
1002242,8,NA,422000,422000,0
1002242,9,NA,422000,422000,0
1002242,10,NA,422000,422000,0
1002242,11,NA,422000,422000,0
1002242,12,NA,422000,422000,0
1002242,13,NA,422000,422000,0
1002242,14,NA,422000,422000,0
1002242,15,NA,422000,422000,0
1002242,16,NA,422000,422000,0
1002242,17,NA,422000,422000,0
1002242,18,NA,422000,422000,0
1002242,19,NA,422000,422000,0
1002242,20,NA,422000,422000,0
1002242,21,NA,422000,422000,0
1002242,22,NA,422000,422000,0
1002242,23,NA,422000,422000,0
1002242,24,NA,422000,422000,0
1002245,1,35,474000,460000,-14000
1002245,2,69,460000,461000,1000
1002245,3,53,461000,462000,1000
1002245,4,58,462000,465000,3000
1002245,5,64,465000,476000,11000
1002245,6,52,476000,481000,5000
1002245,7,39,481000,470000,-11000
1002245,8,40,470000,451000,-19000
1002245,9,76,451000,456000,5000
1002245,10,74,456000,472000,16000
1002245,11,59,472000,487000,15000
1002245,12,67,487000,503000,16000
1002245,13,72,503000,522000,19000
1002245,14,64,522000,535000,13000
1002245,15,NA,535000,535000,0
1002245,16,92,535000,561000,26000
1002245,17,65,561000,576000,15000
1002245,18,79,576000,591000,15000
1002245,19,91,591000,614000,23000
1002245,20,63,614000,621000,7000
1002245,21,74,621000,623000,2000
1002245,22,48,623000,605000,-18000
1002245,23,87,605000,603000,-2000
1002245,24,66,603000,595000,-8000
1002248,1,NA,451000,451000,0
1002248,2,NA,451000,451000,0
1002248,3,NA,451000,451000,0
1002248,4,NA,451000,451000,0
1002248,5,NA,451000,451000,0
1002248,6,NA,451000,451000,0
1002248,7,NA,451000,451000,0
1002248,8,NA,451000,451000,0
1002248,9,NA,451000,451000,0
1002248,10,NA,451000,451000,0
1002248,11,NA,451000,451000,0
1002248,12,NA,451000,451000,0
1002248,13,NA,451000,451000,0
1002248,14,NA,451000,451000,0
1002248,15,NA,451000,451000,0
1002248,16,NA,451000,451000,0
1002248,17,64,451000,458000,7000
1002248,18,NA,458000,458000,0
1002248,19,NA,458000,458000,0
1002248,20,NA,458000,458000,0
1002248,21,NA,458000,458000,0
1002248,22,62,458000,468000,10000
1002248,23,48,468000,470000,2000
1002248,24,28,470000,449000,-21000
1002251,1,66,318000,340000,22000
1002251,2,59,340000,370000,30000
1002251,3,72,370000,411000,41000
1002251,4,95,411000,469000,58000
1002251,5,NA,469000,469000,0
1002251,6,95,469000,533000,64000
1002251,7,48,533000,558000,25000
1002251,8,46,558000,556000,-2000
1002251,9,42,556000,534000,-22000
1002251,10,112,534000,550000,16000
1002251,11,100,550000,584000,34000
1002251,12,39,584000,587000,3000
1002251,13,NA,587000,587000,0
1002251,14,NA,587000,587000,0
1002251,15,NA,587000,587000,0
1002251,16,NA,587000,587000,0
1002251,17,NA,587000,587000,0
1002251,18,44,587000,572000,-15000
1002251,19,86,572000,575000,3000
1002251,20,54,575000,561000,-14000
1002251,21,74,561000,557000,-4000
1002251,22,NA,557000,557000,0
1002251,23,70,557000,562000,5000
1002251,24,91,562000,580000,18000
1002253,1,73,590000,594000,4000
1002253,2,75,594000,601000,7000
1002253,3,63,601000,601000,0
1002253,4,60,601000,593000,-8000
1002253,5,50,593000,574000,-19000
1002253,6,51,574000,550000,-24000
1002253,7,NA,550000,550000,0
1002253,8,NA,550000,550000,0
1002253,9,48,550000,523000,-27000
1002253,10,52,523000,500000,-23000
1002253,11,68,500000,494000,-6000
1002253,12,60,494000,493000,-1000
1002253,13,66,493000,500000,7000
1002253,14,51,500000,502000,2000
1002253,15,NA,502000,502000,0
1002253,16,98,502000,530000,28000
1002253,17,77,530000,556000,26000
1002253,18,82,556000,583000,27000
1002253,19,48,583000,585000,2000
1002253,20,64,585000,580000,-5000
1002253,21,NA,580000,580000,0
1002253,22,36,580000,550000,-30000
1002253,23,85,550000,544000,-6000
1002253,24,83,544000,551000,7000
1002256,1,NA,377000,377000,0
1002256,2,NA,377000,377000,0
1002256,3,NA,377000,377000,0
1002256,4,NA,377000,377000,0
1002256,5,NA,377000,377000,0
1002256,6,NA,377000,377000,0
1002256,7,NA,377000,377000,0
1002256,8,NA,377000,377000,0
1002256,9,NA,377000,377000,0
1002256,10,NA,377000,377000,0
1002256,11,NA,377000,377000,0
1002256,12,29,377000,365000,-12000
1002256,13,32,365000,348000,-17000
1002256,14,24,348000,327000,-21000
1002256,15,NA,327000,327000,0
1002256,16,NA,327000,327000,0
1002256,17,NA,327000,327000,0
1002256,18,46,327000,318000,-9000
1002256,19,75,318000,341000,23000
1002256,20,35,341000,353000,12000
1002256,21,79,353000,388000,35000
1002256,22,87,388000,439000,51000
1002256,23,95,439000,498000,59000
1002256,24,65,498000,534000,36000
1002259,1,12,623000,579000,-44000
1002259,2,11,579000,506000,-73000
1002259,3,35,506000,440000,-66000
1002259,4,58,440000,407000,-33000
1002259,5,NA,407000,407000,0
1002259,6,30,407000,380000,-27000
1002259,7,NA,380000,380000,0
1002259,8,NA,380000,380000,0
1002259,9,NA,380000,380000,0
1002259,10,NA,380000,380000,0
1002259,11,NA,380000,380000,0
1002259,12,37,380000,363000,-17000
1002259,13,NA,363000,363000,0
1002259,14,NA,363000,363000,0
1002259,15,NA,363000,363000,0
1002259,16,NA,363000,363000,0
1002259,17,NA,363000,363000,0
1002259,18,NA,363000,363000,0
1002259,19,NA,363000,363000,0
1002259,20,NA,363000,363000,0
1002259,21,NA,363000,363000,0
1002259,22,NA,363000,363000,0
1002259,23,NA,363000,363000,0
1002259,24,NA,363000,363000,0
1002264,1,62,604000,598000,-6000
1002264,2,91,598000,611000,13000
1002264,3,65,611000,615000,4000
1002264,4,95,615000,633000,18000
1002264,5,78,633000,649000,16000
1002264,6,83,649000,664000,15000
1002264,7,90,664000,679000,15000
1002264,8,86,679000,693000,14000
1002264,9,77,693000,696000,3000
1002264,10,62,696000,683000,-13000
1002264,11,3,683000,618000,-65000
1002264,12,NA,618000,618000,0
1002264,13,NA,618000,618000,0
1002264,14,NA,618000,618000,0
1002264,15,NA,618000,618000,0
1002264,16,NA,618000,618000,0
1002264,17,NA,618000,618000,0
1002264,18,41,618000,554000,-64000
1002264,19,49,554000,502000,-52000
1002264,20,90,502000,494000,-8000
1002264,21,108,494000,530000,36000
1002264,22,30,530000,536000,6000
1002264,23,63,536000,541000,5000
1002264,24,48,541000,528000,-13000
1002267,1,108,824000,834000,10000
1002267,2,123,834000,860000,26000
1002267,3,NA,860000,860000,0
1002267,4,91,860000,870000,10000
1002267,5,76,870000,857000,-13000
1002267,6,66,857000,824000,-33000
1002267,7,NA,824000,824000,0
1002267,8,69,824000,780000,-44000
1002267,9,95,780000,754000,-26000
1002267,10,NA,754000,754000,0
1002267,11,NA,754000,754000,0
1002267,12,NA,754000,754000,0
1002267,13,NA,754000,754000,0
1002267,14,NA,754000,754000,0
1002267,15,NA,754000,754000,0
1002267,16,63,754000,723000,-31000
1002267,17,122,723000,733000,10000
1002267,18,138,733000,779000,46000
1002267,19,104,779000,818000,39000
1002267,20,120,818000,858000,40000
1002267,21,82,858000,868000,10000
1002267,22,107,868000,871000,3000
1002267,23,NA,871000,871000,0
1002267,24,NA,871000,871000,0
1002282,1,75,489000,503000,14000
1002282,2,52,503000,508000,5000
1002282,3,47,508000,503000,-5000
1002282,4,67,503000,504000,1000
1002282,5,6,504000,466000,-38000
1002282,6,NA,466000,466000,0
1002282,7,NA,466000,466000,0
1002282,8,NA,466000,466000,0
1002282,9,54,466000,440000,-26000
1002282,10,50,440000,424000,-16000
1002282,11,55,424000,419000,-5000
1002282,12,46,419000,414000,-5000
1002282,13,34,414000,405000,-9000
1002282,14,NA,405000,405000,0
1002282,15,7,405000,370000,-35000
1002282,16,NA,370000,370000,0
1002282,17,52,370000,353000,-17000
1002282,18,46,353000,346000,-7000
1002282,19,NA,346000,346000,0
1002282,20,NA,346000,346000,0
1002282,21,NA,346000,346000,0
1002282,22,NA,346000,346000,0
1002282,23,NA,346000,346000,0
1002282,24,NA,346000,346000,0
1002312,1,78,622000,627000,5000
1002312,2,38,627000,605000,-22000
1002312,3,54,605000,578000,-27000
1002312,4,52,578000,549000,-29000
1002312,5,79,549000,544000,-5000
1002312,6,74,544000,550000,6000
1002312,7,102,550000,584000,34000
1002312,8,78,584000,613000,29000
1002312,9,84,613000,640000,27000
1002312,10,47,640000,632000,-8000
1002312,11,94,632000,639000,7000
1002312,12,NA,639000,639000,0
1002312,13,66,639000,632000,-7000
1002312,14,112,632000,659000,27000
1002312,15,75,659000,672000,13000
1002312,16,69,672000,676000,4000
1002312,17,75,676000,671000,-5000
1002312,18,80,671000,668000,-3000
1002312,19,NA,668000,668000,0
1002312,20,NA,668000,668000,0
1002312,21,69,668000,656000,-12000
1002312,22,74,656000,647000,-9000
1002312,23,75,647000,641000,-6000
1002312,24,46,641000,614000,-27000
1002347,1,16,483000,454000,-29000
1002347,2,61,454000,439000,-15000
1002347,3,59,439000,436000,-3000
1002347,4,36,436000,424000,-12000
1002347,5,53,424000,422000,-2000
1002347,6,58,422000,430000,8000
1002347,7,67,430000,445000,15000
1002347,8,74,445000,470000,25000
1002347,9,50,470000,482000,12000
1002347,10,55,482000,487000,5000
1002347,11,NA,487000,487000,0
1002347,12,NA,487000,487000,0
1002347,13,54,487000,485000,-2000
1002347,14,35,485000,469000,-16000
1002347,15,59,469000,459000,-10000
1002347,16,14,459000,426000,-33000
1002347,17,37,426000,396000,-30000
1002347,18,64,396000,390000,-6000
1002347,19,57,390000,397000,7000
1002347,20,31,397000,391000,-6000
1002347,21,37,391000,384000,-7000
1002347,22,47,384000,379000,-5000
1002347,23,22,379000,358000,-21000
1002347,24,38,358000,341000,-17000
1002401,1,15,573000,535000,-38000
1002401,2,48,535000,498000,-37000
1002401,3,81,498000,491000,-7000
1002401,4,47,491000,481000,-10000
1002401,5,46,481000,471000,-10000
1002401,6,34,471000,455000,-16000
1002401,7,47,455000,438000,-17000
1002401,8,56,438000,430000,-8000
1002401,9,46,430000,423000,-7000
1002401,10,57,423000,425000,2000
1002401,11,50,425000,428000,3000
1002401,12,NA,428000,428000,0
1002401,13,50,428000,429000,1000
1002401,14,20,429000,410000,-19000
1002401,15,50,410000,398000,-12000
1002401,16,64,398000,402000,4000
1002401,17,49,402000,406000,4000
1002401,18,67,406000,423000,17000
1002401,19,33,423000,424000,1000
1002401,20,57,424000,428000,4000
1002401,21,50,428000,428000,0
1002401,22,54,428000,429000,1000
1002401,23,72,429000,444000,15000
1002401,24,41,444000,445000,1000
1002403,1,45,383000,384000,1000
1002403,2,NA,384000,384000,0
1002403,3,NA,384000,384000,0
1002403,4,NA,384000,384000,0
1002403,5,69,384000,401000,17000
1002403,6,34,401000,404000,3000
1002403,7,26,404000,390000,-14000
1002403,8,87,390000,410000,20000
1002403,9,43,410000,418000,8000
1002403,10,NA,418000,418000,0
1002403,11,15,418000,397000,-21000
1002403,12,NA,397000,397000,0
1002403,13,NA,397000,397000,0
1002403,14,78,397000,410000,13000
1002403,15,NA,410000,410000,0
1002403,16,20,410000,397000,-13000
1002403,17,58,397000,393000,-4000
1002403,18,44,393000,391000,-2000
1002403,19,33,391000,382000,-9000
1002403,20,38,382000,370000,-12000
1002403,21,NA,370000,370000,0
1002403,22,NA,370000,370000,0
1002403,23,NA,370000,370000,0
1002403,24,NA,370000,370000,0
1002404,1,53,625000,611000,-14000
1002404,2,79,611000,607000,-4000
1002404,3,74,607000,607000,0
1002404,4,58,607000,598000,-9000
1002404,5,52,598000,581000,-17000
1002404,6,74,581000,577000,-4000
1002404,7,88,577000,587000,10000
1002404,8,79,587000,601000,14000
1002404,9,60,601000,604000,3000
1002404,10,75,604000,609000,5000
1002404,11,52,609000,595000,-14000
1002404,12,63,595000,579000,-16000
1002404,13,35,579000,545000,-34000
1002404,14,67,545000,530000,-15000
1002404,15,NA,530000,530000,0
1002404,16,63,530000,521000,-9000
1002404,17,81,521000,531000,10000
1002404,18,99,531000,564000,33000
1002404,19,83,564000,598000,34000
1002404,20,51,598000,605000,7000
1002404,21,70,605000,606000,1000
1002404,22,45,606000,584000,-22000
1002404,23,65,584000,564000,-20000
1002404,24,72,564000,553000,-11000
1002795,1,NA,355000,355000,0
1002795,2,NA,355000,355000,0
1002795,3,NA,355000,355000,0
1002795,4,NA,355000,355000,0
1002795,5,NA,355000,355000,0
1002795,6,NA,355000,355000,0
1002795,7,NA,355000,355000,0
1002795,8,NA,355000,355000,0
1002795,9,NA,355000,355000,0
1002795,10,44,355000,355000,0
1002795,11,49,355000,361000,6000
1002795,12,41,361000,363000,2000
1002795,13,57,363000,375000,12000
1002795,14,46,375000,385000,10000
1002795,15,NA,385000,385000,0
1002795,16,58,385000,399000,14000
1002795,17,44,399000,404000,5000
1002795,18,49,404000,408000,4000
1002795,19,NA,408000,408000,0
1002795,20,NA,408000,408000,0
1002795,21,NA,408000,408000,0
1002795,22,NA,408000,408000,0
1002795,23,NA,408000,408000,0
1002795,24,NA,408000,408000,0
1002922,1,83,305000,340000,35000
1002922,2,NA,340000,340000,0
1002922,3,NA,340000,340000,0
1002922,4,14,340000,346000,6000
1002922,5,17,346000,332000,-14000
1002922,6,NA,332000,332000,0
1002922,7,NA,332000,332000,0
1002922,8,18,332000,307000,-25000
1002922,9,29,307000,284000,-23000
1002922,10,NA,284000,284000,0
1002922,11,NA,284000,284000,0
1002922,12,NA,284000,284000,0
1002922,13,NA,284000,284000,0
1002922,14,NA,284000,284000,0
1002922,15,NA,284000,284000,0
1002922,16,NA,284000,284000,0
1002922,17,NA,284000,284000,0
1002922,18,NA,284000,284000,0
1002922,19,43,284000,273000,-11000
1002922,20,NA,273000,273000,0
1002922,21,NA,273000,273000,0
1002922,22,NA,273000,273000,0
1002922,23,NA,273000,273000,0
1002922,24,NA,273000,273000,0
1002938,1,NA,358000,358000,0
1002938,2,NA,358000,358000,0
1002938,3,NA,358000,358000,0
1002938,4,51,358000,363000,5000
1002938,5,34,363000,362000,-1000
1002938,6,37,362000,358000,-4000
1002938,7,34,358000,348000,-10000
1002938,8,38,348000,340000,-8000
1002938,9,NA,340000,340000,0
1002938,10,NA,340000,340000,0
1002938,11,NA,340000,340000,0
1002938,12,NA,340000,340000,0
1002938,13,NA,340000,340000,0
1002938,14,NA,340000,340000,0
1002938,15,NA,340000,340000,0
1002938,16,NA,340000,340000,0
1002938,17,NA,340000,340000,0
1002938,18,NA,340000,340000,0
1002938,19,25,340000,324000,-16000
1002938,20,NA,324000,324000,0
1002938,21,NA,324000,324000,0
1002938,22,NA,324000,324000,0
1002938,23,NA,324000,324000,0
1002938,24,NA,324000,324000,0
1002947,1,46,455000,450000,-5000
1002947,2,20,450000,423000,-27000
1002947,3,49,423000,405000,-18000
1002947,4,41,405000,389000,-16000
1002947,5,NA,389000,389000,0
1002947,6,33,389000,373000,-16000
1002947,7,23,373000,349000,-24000
1002947,8,32,349000,330000,-19000
1002947,9,62,330000,335000,5000
1002947,10,21,335000,325000,-10000
1002947,11,16,325000,305000,-20000
1002947,12,NA,305000,305000,0
1002947,13,44,305000,300000,-5000
1002947,14,44,300000,303000,3000
1002947,15,NA,303000,303000,0
1002947,16,52,303000,316000,13000
1002947,17,50,316000,335000,19000
1002947,18,66,335000,366000,31000
1002947,19,41,366000,383000,17000
1002947,20,76,383000,413000,30000
1002947,21,25,413000,413000,0
1002947,22,58,413000,417000,4000
1002947,23,68,417000,431000,14000
1002947,24,55,431000,440000,9000
1003130,1,NA,711000,711000,0
1003130,2,NA,711000,711000,0
1003130,3,NA,711000,711000,0
1003130,4,NA,711000,711000,0
1003130,5,NA,711000,711000,0
1003130,6,NA,711000,711000,0
1003130,7,NA,711000,711000,0
1003130,8,NA,711000,711000,0
1003130,9,NA,711000,711000,0
1003130,10,NA,711000,711000,0
1003130,11,NA,711000,711000,0
1003130,12,NA,711000,711000,0
1003130,13,57,711000,690000,-21000
1003130,14,NA,690000,690000,0
1003130,15,71,690000,669000,-21000
1003130,16,70,669000,650000,-19000
1003130,17,67,650000,631000,-19000
1003130,18,76,631000,622000,-9000
1003130,19,75,622000,620000,-2000
1003130,20,71,620000,618000,-2000
1003130,21,51,618000,602000,-16000
1003130,22,107,602000,616000,14000
1003130,23,57,616000,614000,-2000
1003130,24,65,614000,605000,-9000
1003192,1,NA,549000,549000,0
1003192,2,NA,549000,549000,0
1003192,3,NA,549000,549000,0
1003192,4,45,549000,533000,-16000
1003192,5,15,533000,489000,-44000
1003192,6,42,489000,449000,-40000
1003192,7,47,449000,420000,-29000
1003192,8,60,420000,413000,-7000
1003192,9,51,413000,414000,1000
1003192,10,32,414000,406000,-8000
1003192,11,56,406000,407000,1000
1003192,12,11,407000,381000,-26000
1003192,13,NA,381000,381000,0
1003192,14,NA,381000,381000,0
1003192,15,NA,381000,381000,0
1003192,16,NA,381000,381000,0
1003192,17,NA,381000,381000,0
1003192,18,NA,381000,381000,0
1003192,19,NA,381000,381000,0
1003192,20,NA,381000,381000,0
1003192,21,NA,381000,381000,0
1003192,22,NA,381000,381000,0
1003192,23,NA,381000,381000,0
1003192,24,NA,381000,381000,0
1003203,1,63,458000,466000,8000
1003203,2,32,466000,455000,-11000
1003203,3,NA,455000,455000,0
1003203,4,NA,455000,455000,0
1003203,5,51,455000,446000,-9000
1003203,6,55,446000,442000,-4000
1003203,7,48,442000,437000,-5000
1003203,8,98,437000,468000,31000
1003203,9,63,468000,495000,27000
1003203,10,72,495000,520000,25000
1003203,11,60,520000,534000,14000
1003203,12,NA,534000,534000,0
1003203,13,58,534000,537000,3000
1003203,14,46,537000,525000,-12000
1003203,15,106,525000,547000,22000
1003203,16,45,547000,547000,0
1003203,17,68,547000,550000,3000
1003203,18,75,550000,559000,9000
1003203,19,65,559000,563000,4000
1003203,20,73,563000,567000,4000
1003203,21,81,567000,582000,15000
1003203,22,95,582000,608000,26000
1003203,23,72,608000,623000,15000
1003203,24,51,623000,614000,-9000
1003520,1,NA,241000,241000,0
1003520,2,48,241000,255000,14000
1003520,3,22,255000,260000,5000
1003520,4,26,260000,260000,0
1003520,5,51,260000,274000,14000
1003520,6,33,274000,283000,9000
1003520,7,NA,283000,283000,0
1003520,8,NA,283000,283000,0
1003520,9,NA,283000,283000,0
1003520,10,NA,283000,283000,0
1003520,11,NA,283000,283000,0
1003520,12,NA,283000,283000,0
1003520,13,NA,283000,283000,0
1003520,14,NA,283000,283000,0
1003520,15,NA,283000,283000,0
1003520,16,NA,283000,283000,0
1003520,17,NA,283000,283000,0
1003520,18,NA,283000,283000,0
1003520,19,NA,283000,283000,0
1003520,20,NA,283000,283000,0
1003520,21,NA,283000,283000,0
1003520,22,NA,283000,283000,0
1003520,23,NA,283000,283000,0
1003520,24,NA,283000,283000,0
1003546,1,NA,298000,298000,0
1003546,2,NA,298000,298000,0
1003546,3,NA,298000,298000,0
1003546,4,NA,298000,298000,0
1003546,5,NA,298000,298000,0
1003546,6,NA,298000,298000,0
1003546,7,NA,298000,298000,0
1003546,8,NA,298000,298000,0
1003546,9,NA,298000,298000,0
1003546,10,NA,298000,298000,0
1003546,11,NA,298000,298000,0
1003546,12,27,298000,291000,-7000
1003546,13,59,291000,304000,13000
1003546,14,NA,304000,304000,0
1003546,15,65,304000,334000,30000
1003546,16,27,334000,345000,11000
1003546,17,0,345000,322000,-23000
1003546,18,23,322000,296000,-26000
1003546,19,19,296000,265000,-31000
1003546,20,28,265000,242000,-23000
1003546,21,43,242000,242000,0
1003546,22,31,242000,248000,6000
1003546,23,46,248000,264000,16000
1003546,24,50,264000,287000,23000
1004034,1,68,482000,491000,9000
1004034,2,46,491000,490000,-1000
1004034,3,NA,490000,490000,0
1004034,4,38,490000,474000,-16000
1004034,5,45,474000,457000,-17000
1004034,6,19,457000,421000,-36000
1004034,7,44,421000,394000,-27000
1004034,8,44,394000,378000,-16000
1004034,9,80,378000,396000,18000
1004034,10,82,396000,434000,38000
1004034,11,49,434000,459000,25000
1004034,12,43,459000,465000,6000
1004034,13,42,465000,457000,-8000
1004034,14,NA,457000,457000,0
1004034,15,28,457000,430000,-27000
1004034,16,30,430000,397000,-33000
1004034,17,72,397000,395000,-2000
1004034,18,65,395000,409000,14000
1004034,19,84,409000,446000,37000
1004034,20,51,446000,469000,23000
1004034,21,76,469000,498000,29000
1004034,22,43,498000,500000,2000
1004034,23,37,500000,483000,-17000
1004034,24,63,483000,472000,-11000
1004069,1,NA,200000,200000,0
1004069,2,NA,200000,200000,0
1004069,3,NA,200000,200000,0
1004069,4,NA,200000,200000,0
1004069,5,NA,200000,200000,0
1004069,6,NA,200000,200000,0
1004069,7,NA,200000,200000,0
1004069,8,NA,200000,200000,0
1004069,9,NA,200000,200000,0
1004069,10,NA,200000,200000,0
1004069,11,NA,200000,200000,0
1004069,12,NA,200000,200000,0
1004069,13,NA,200000,200000,0
1004069,14,NA,200000,200000,0
1004069,15,NA,200000,200000,0
1004069,16,NA,200000,200000,0
1004069,17,NA,200000,200000,0
1004069,18,NA,200000,200000,0
1004069,19,NA,200000,200000,0
1004069,20,NA,200000,200000,0
1004069,21,NA,200000,200000,0
1004069,22,NA,200000,200000,0
1004069,23,NA,200000,200000,0
1004069,24,NA,200000,200000,0
1004095,1,46,565000,551000,-14000
1004095,2,77,551000,551000,0
1004095,3,90,551000,570000,19000
1004095,4,38,570000,562000,-8000
1004095,5,111,562000,590000,28000
1004095,6,99,590000,631000,41000
1004095,7,47,631000,635000,4000
1004095,8,76,635000,636000,1000
1004095,9,63,636000,629000,-7000
1004095,10,52,629000,603000,-26000
1004095,11,72,603000,587000,-16000
1004095,12,93,587000,596000,9000
1004095,13,NA,596000,596000,0
1004095,14,91,596000,621000,25000
1004095,15,69,621000,634000,13000
1004095,16,59,634000,632000,-2000
1004095,17,62,632000,619000,-13000
1004095,18,81,619000,613000,-6000
1004095,19,101,613000,629000,16000
1004095,20,48,629000,622000,-7000
1004095,21,71,622000,618000,-4000
1004095,22,75,618000,615000,-3000
1004095,23,65,615000,607000,-8000
1004095,24,NA,607000,607000,0
1004113,1,NA,200000,200000,0
1004113,2,NA,200000,200000,0
1004113,3,NA,200000,200000,0
1004113,4,NA,200000,200000,0
1004113,5,35,200000,208000,8000
1004113,6,20,208000,211000,3000
1004113,7,NA,211000,211000,0
1004113,8,NA,211000,211000,0
1004113,9,28,211000,215000,4000
1004113,10,29,215000,219000,4000
1004113,11,NA,219000,219000,0
1004113,12,NA,219000,219000,0
1004113,13,NA,219000,219000,0
1004113,14,NA,219000,219000,0
1004113,15,NA,219000,219000,0
1004113,16,NA,219000,219000,0
1004113,17,NA,219000,219000,0
1004113,18,NA,219000,219000,0
1004113,19,NA,219000,219000,0
1004113,20,NA,219000,219000,0
1004113,21,NA,219000,219000,0
1004113,22,NA,219000,219000,0
1004113,23,NA,219000,219000,0
1004113,24,NA,219000,219000,0
1004364,1,95,522000,548000,26000
1004364,2,84,548000,582000,34000
1004364,3,38,582000,582000,0
1004364,4,NA,582000,582000,0
1004364,5,NA,582000,582000,0
1004364,6,NA,582000,582000,0
1004364,7,NA,582000,582000,0
1004364,8,NA,582000,582000,0
1004364,9,NA,582000,582000,0
1004364,10,NA,582000,582000,0
1004364,11,NA,582000,582000,0
1004364,12,NA,582000,582000,0
1004364,13,NA,582000,582000,0
1004364,14,NA,582000,582000,0
1004364,15,NA,582000,582000,0
1004364,16,NA,582000,582000,0
1004364,17,NA,582000,582000,0
1004364,18,NA,582000,582000,0
1004364,19,NA,582000,582000,0
1004364,20,NA,582000,582000,0
1004364,21,NA,582000,582000,0
1004364,22,NA,582000,582000,0
1004364,23,NA,582000,582000,0
1004364,24,NA,582000,582000,0
1004385,1,58,358000,370000,12000
1004385,2,54,370000,388000,18000
1004385,3,96,388000,436000,48000
1004385,4,89,436000,494000,58000
1004385,5,96,494000,556000,62000
1004385,6,67,556000,594000,38000
1004385,7,45,594000,596000,2000
1004385,8,92,596000,607000,11000
1004385,9,55,607000,598000,-9000
1004385,10,35,598000,565000,-33000
1004385,11,80,565000,555000,-10000
1004385,12,69,555000,553000,-2000
1004385,13,57,553000,544000,-9000
1004385,14,NA,544000,544000,0
1004385,15,27,544000,517000,-27000
1004385,16,44,517000,490000,-27000
1004385,17,40,490000,457000,-33000
1004385,18,37,457000,426000,-31000
1004385,19,56,426000,412000,-14000
1004385,20,68,412000,422000,10000
1004385,21,75,422000,447000,25000
1004385,22,49,447000,461000,14000
1004385,23,106,461000,506000,45000
1004385,24,79,506000,543000,37000
1004530,1,44,522000,510000,-12000
1004530,2,11,510000,466000,-44000
1004530,3,NA,466000,466000,0
1004530,4,NA,466000,466000,0
1004530,5,NA,466000,466000,0
1004530,6,NA,466000,466000,0
1004530,7,NA,466000,466000,0
1004530,8,NA,466000,466000,0
1004530,9,NA,466000,466000,0
1004530,10,NA,466000,466000,0
1004530,11,NA,466000,466000,0
1004530,12,NA,466000,466000,0
1004530,13,NA,466000,466000,0
1004530,14,NA,466000,466000,0
1004530,15,NA,466000,466000,0
1004530,16,NA,466000,466000,0
1004530,17,NA,466000,466000,0
1004530,18,47,466000,430000,-36000
1004530,19,NA,430000,430000,0
1004530,20,NA,430000,430000,0
1004530,21,NA,430000,430000,0
1004530,22,13,430000,382000,-48000
1004530,23,NA,382000,382000,0
1004530,24,NA,382000,382000,0
1004592,1,115,901000,909000,8000
1004592,2,117,909000,924000,15000
1004592,3,111,924000,937000,13000
1004592,4,145,937000,969000,32000
1004592,5,123,969000,996000,27000
1004592,6,129,996000,1022000,26000
1004592,7,99,1022000,1020000,-2000
1004592,8,151,1020000,1040000,20000
1004592,9,92,1040000,1027000,-13000
1004592,10,121,1027000,1017000,-10000
1004592,11,95,1017000,993000,-24000
1004592,12,158,993000,1007000,14000
1004592,13,76,1007000,984000,-23000
1004592,14,134,984000,991000,7000
1004592,15,NA,991000,991000,0
1004592,16,108,991000,987000,-4000
1004592,17,94,987000,968000,-19000
1004592,18,140,968000,971000,3000
1004592,19,98,971000,965000,-6000
1004592,20,153,965000,987000,22000
1004592,21,131,987000,1013000,26000
1004592,22,96,1013000,1012000,-1000
1004592,23,146,1012000,1027000,15000
1004592,24,98,1027000,1015000,-12000
1004757,1,81,439000,461000,22000
1004757,2,38,461000,467000,6000
1004757,3,63,467000,476000,9000
1004757,4,47,476000,474000,-2000
1004757,5,63,474000,477000,3000
1004757,6,72,477000,490000,13000
1004757,7,78,490000,513000,23000
1004757,8,25,513000,503000,-10000
1004757,9,54,503000,492000,-11000
1004757,10,53,492000,479000,-13000
1004757,11,37,479000,456000,-23000
1004757,12,23,456000,420000,-36000
1004757,13,59,420000,407000,-13000
1004757,14,NA,407000,407000,0
1004757,15,14,407000,376000,-31000
1004757,16,49,376000,362000,-14000
1004757,17,54,362000,363000,1000
1004757,18,46,363000,368000,5000
1004757,19,56,368000,380000,12000
1004757,20,52,380000,395000,15000
1004757,21,61,395000,412000,17000
1004757,22,84,412000,446000,34000
1004757,23,43,446000,460000,14000
1004757,24,NA,460000,460000,0
1004819,1,NA,360000,360000,0
1004819,2,NA,360000,360000,0
1004819,3,NA,360000,360000,0
1004819,4,47,360000,362000,2000
1004819,5,59,362000,377000,15000
1004819,6,39,377000,384000,7000
1004819,7,43,384000,385000,1000
1004819,8,44,385000,385000,0
1004819,9,56,385000,391000,6000
1004819,10,25,391000,379000,-12000
1004819,11,47,379000,373000,-6000
1004819,12,42,373000,368000,-5000
1004819,13,52,368000,371000,3000
1004819,14,38,371000,371000,0
1004819,15,NA,371000,371000,0
1004819,16,22,371000,356000,-15000
1004819,17,33,356000,339000,-17000
1004819,18,47,339000,333000,-6000
1004819,19,28,333000,322000,-11000
1004819,20,32,322000,312000,-10000
1004819,21,18,312000,294000,-18000
1004819,22,43,294000,289000,-5000
1004819,23,49,289000,295000,6000
1004819,24,62,295000,319000,24000
1004848,1,104,585000,612000,27000
1004848,2,53,612000,619000,7000
1004848,3,61,619000,614000,-5000
1004848,4,55,614000,597000,-17000
1004848,5,48,597000,570000,-27000
1004848,6,29,570000,525000,-45000
1004848,7,50,525000,490000,-35000
1004848,8,NA,490000,490000,0
1004848,9,NA,490000,490000,0
1004848,10,39,490000,456000,-34000
1004848,11,NA,456000,456000,0
1004848,12,NA,456000,456000,0
1004848,13,NA,456000,456000,0
1004848,14,17,456000,414000,-42000
1004848,15,NA,414000,414000,0
1004848,16,NA,414000,414000,0
1004848,17,NA,414000,414000,0
1004848,18,NA,414000,414000,0
1004848,19,NA,414000,414000,0
1004848,20,NA,414000,414000,0
1004848,21,27,414000,374000,-40000
1004848,22,77,374000,374000,0
1004848,23,69,374000,394000,20000
1004848,24,85,394000,434000,40000
1004863,1,65,538000,540000,2000
1004863,2,58,540000,539000,-1000
1004863,3,86,539000,555000,16000
1004863,4,67,555000,566000,11000
1004863,5,81,566000,584000,18000
1004863,6,48,584000,581000,-3000
1004863,7,80,581000,586000,5000
1004863,8,45,586000,570000,-16000
1004863,9,91,570000,577000,7000
1004863,10,11,577000,540000,-37000
1004863,11,NA,540000,540000,0
1004863,12,61,540000,516000,-24000
1004863,13,64,516000,502000,-14000
1004863,14,NA,502000,502000,0
1004863,15,83,502000,514000,12000
1004863,16,119,514000,563000,49000
1004863,17,94,563000,618000,55000
1004863,18,80,618000,656000,38000
1004863,19,99,656000,691000,35000
1004863,20,66,691000,698000,7000
1004863,21,124,698000,725000,27000
1004863,22,93,725000,745000,20000
1004863,23,66,745000,742000,-3000
1004863,24,85,742000,733000,-9000
1004870,1,61,584000,579000,-5000
1004870,2,56,579000,568000,-11000
1004870,3,60,568000,556000,-12000
1004870,4,87,556000,565000,9000
1004870,5,75,565000,578000,13000
1004870,6,61,578000,583000,5000
1004870,7,79,583000,594000,11000
1004870,8,78,594000,606000,12000
1004870,9,43,606000,591000,-15000
1004870,10,59,591000,572000,-19000
1004870,11,76,572000,567000,-5000
1004870,12,79,567000,572000,5000
1004870,13,NA,572000,572000,0
1004870,14,89,572000,594000,22000
1004870,15,59,594000,601000,7000
1004870,16,36,601000,581000,-20000
1004870,17,85,581000,578000,-3000
1004870,18,97,578000,594000,16000
1004870,19,66,594000,601000,7000
1004870,20,94,601000,624000,23000
1004870,21,36,624000,613000,-11000
1004870,22,69,613000,600000,-13000
1004870,23,93,600000,604000,4000
1004870,24,75,604000,608000,4000
1004894,1,58,267000,287000,20000
1004894,2,NA,287000,287000,0
1004894,3,NA,287000,287000,0
1004894,4,28,287000,297000,10000
1004894,5,NA,297000,297000,0
1004894,6,NA,297000,297000,0
1004894,7,NA,297000,297000,0
1004894,8,NA,297000,297000,0
1004894,9,NA,297000,297000,0
1004894,10,NA,297000,297000,0
1004894,11,NA,297000,297000,0
1004894,12,NA,297000,297000,0
1004894,13,NA,297000,297000,0
1004894,14,NA,297000,297000,0
1004894,15,NA,297000,297000,0
1004894,16,NA,297000,297000,0
1004894,17,NA,297000,297000,0
1004894,18,NA,297000,297000,0
1004894,19,NA,297000,297000,0
1004894,20,NA,297000,297000,0
1004894,21,NA,297000,297000,0
1004894,22,NA,297000,297000,0
1004894,23,NA,297000,297000,0
1004894,24,NA,297000,297000,0
1004909,1,NA,561000,561000,0
1004909,2,NA,561000,561000,0
1004909,3,NA,561000,561000,0
1004909,4,NA,561000,561000,0
1004909,5,NA,561000,561000,0
1004909,6,NA,561000,561000,0
1004909,7,NA,561000,561000,0
1004909,8,NA,561000,561000,0
1004909,9,NA,561000,561000,0
1004909,10,NA,561000,561000,0
1004909,11,NA,561000,561000,0
1004909,12,NA,561000,561000,0
1004909,13,NA,561000,561000,0
1004909,14,NA,561000,561000,0
1004909,15,NA,561000,561000,0
1004909,16,NA,561000,561000,0
1004909,17,51,561000,550000,-11000
1004909,18,55,550000,534000,-16000
1004909,19,46,534000,512000,-22000
1004909,20,71,512000,506000,-6000
1004909,21,NA,506000,506000,0
1004909,22,NA,506000,506000,0
1004909,23,NA,506000,506000,0
1004909,24,NA,506000,506000,0
1004912,1,76,552000,561000,9000
1004912,2,79,561000,578000,17000
1004912,3,58,578000,583000,5000
1004912,4,60,583000,579000,-4000
1004912,5,61,579000,571000,-8000
1004912,6,NA,571000,571000,0
1004912,7,NA,571000,571000,0
1004912,8,NA,571000,571000,0
1004912,9,NA,571000,571000,0
1004912,10,NA,571000,571000,0
1004912,11,48,571000,549000,-22000
1004912,12,61,549000,532000,-17000
1004912,13,46,532000,511000,-21000
1004912,14,83,511000,518000,7000
1004912,15,NA,518000,518000,0
1004912,16,NA,518000,518000,0
1004912,17,NA,518000,518000,0
1004912,18,97,518000,547000,29000
1004912,19,105,547000,595000,48000
1004912,20,28,595000,596000,1000
1004912,21,68,596000,594000,-2000
1004912,22,65,594000,584000,-10000
1004912,23,33,584000,548000,-36000
1004912,24,92,548000,542000,-6000
1004938,1,55,537000,532000,-5000
1004938,2,72,532000,536000,4000
1004938,3,77,536000,550000,14000
1004938,4,102,550000,586000,36000
1004938,5,76,586000,614000,28000
1004938,6,60,614000,624000,10000
1004938,7,78,624000,630000,6000
1004938,8,58,630000,620000,-10000
1004938,9,76,620000,613000,-7000
1004938,10,41,613000,586000,-27000
1004938,11,69,586000,571000,-15000
1004938,12,97,571000,582000,11000
1004938,13,NA,582000,582000,0
1004938,14,50,582000,581000,-1000
1004938,15,48,581000,565000,-16000
1004938,16,98,565000,579000,14000
1004938,17,128,579000,628000,49000
1004938,18,104,628000,679000,51000
1004938,19,68,679000,704000,25000
1004938,20,52,704000,696000,-8000
1004938,21,117,696000,710000,14000
1004938,22,44,710000,684000,-26000
1004938,23,92,684000,675000,-9000
1004938,24,74,675000,666000,-9000
1004940,1,NA,329000,329000,0
1004940,2,NA,329000,329000,0
1004940,3,NA,329000,329000,0
1004940,4,NA,329000,329000,0
1004940,5,NA,329000,329000,0
1004940,6,72,329000,353000,24000
1004940,7,47,353000,374000,21000
1004940,8,47,374000,390000,16000
1004940,9,50,390000,402000,12000
1004940,10,18,402000,385000,-17000
1004940,11,NA,385000,385000,0
1004940,12,4,385000,342000,-43000
1004940,13,NA,342000,342000,0
1004940,14,NA,342000,342000,0
1004940,15,NA,342000,342000,0
1004940,16,NA,342000,342000,0
1004940,17,NA,342000,342000,0
1004940,18,NA,342000,342000,0
1004940,19,NA,342000,342000,0
1004940,20,NA,342000,342000,0
1004940,21,NA,342000,342000,0
1004940,22,NA,342000,342000,0
1004940,23,NA,342000,342000,0
1004940,24,NA,342000,342000,0
1004948,1,NA,390000,390000,0
1004948,2,NA,390000,390000,0
1004948,3,NA,390000,390000,0
1004948,4,NA,390000,390000,0
1004948,5,NA,390000,390000,0
1004948,6,NA,390000,390000,0
1004948,7,NA,390000,390000,0
1004948,8,NA,390000,390000,0
1004948,9,NA,390000,390000,0
1004948,10,NA,390000,390000,0
1004948,11,NA,390000,390000,0
1004948,12,NA,390000,390000,0
1004948,13,NA,390000,390000,0
1004948,14,NA,390000,390000,0
1004948,15,NA,390000,390000,0
1004948,16,NA,390000,390000,0
1004948,17,NA,390000,390000,0
1004948,18,NA,390000,390000,0
1004948,19,NA,390000,390000,0
1004948,20,NA,390000,390000,0
1004948,21,NA,390000,390000,0
1004948,22,NA,390000,390000,0
1004948,23,NA,390000,390000,0
1004948,24,NA,390000,390000,0
1004965,1,26,587000,556000,-31000
1004965,2,NA,556000,556000,0
1004965,3,NA,556000,556000,0
1004965,4,NA,556000,556000,0
1004965,5,NA,556000,556000,0
1004965,6,NA,556000,556000,0
1004965,7,NA,556000,556000,0
1004965,8,NA,556000,556000,0
1004965,9,NA,556000,556000,0
1004965,10,NA,556000,556000,0
1004965,11,NA,556000,556000,0
1004965,12,NA,556000,556000,0
1004965,13,NA,556000,556000,0
1004965,14,NA,556000,556000,0
1004965,15,NA,556000,556000,0
1004965,16,NA,556000,556000,0
1004965,17,110,556000,565000,9000
1004965,18,74,565000,577000,12000
1004965,19,85,577000,597000,20000
1004965,20,86,597000,622000,25000
1004965,21,59,622000,629000,7000
1004965,22,53,629000,612000,-17000
1004965,23,54,612000,587000,-25000
1004965,24,47,587000,552000,-35000
1004985,1,21,530000,500000,-30000
1004985,2,87,500000,500000,0
1004985,3,18,500000,472000,-28000
1004985,4,55,472000,455000,-17000
1004985,5,63,455000,453000,-2000
1004985,6,57,453000,459000,6000
1004985,7,81,459000,480000,21000
1004985,8,73,480000,508000,28000
1004985,9,52,508000,519000,11000
1004985,10,33,519000,503000,-16000
1004985,11,63,503000,495000,-8000
1004985,12,NA,495000,495000,0
1004985,13,NA,495000,495000,0
1004985,14,NA,495000,495000,0
1004985,15,50,495000,481000,-14000
1004985,16,NA,481000,481000,0
1004985,17,NA,481000,481000,0
1004985,18,NA,481000,481000,0
1004985,19,NA,481000,481000,0
1004985,20,NA,481000,481000,0
1004985,21,NA,481000,481000,0
1004985,22,NA,481000,481000,0
1004985,23,NA,481000,481000,0
1004985,24,NA,481000,481000,0
1004995,1,39,320000,322000,2000
1004995,2,NA,322000,322000,0
1004995,3,25,322000,313000,-9000
1004995,4,12,313000,290000,-23000
1004995,5,44,290000,282000,-8000
1004995,6,35,282000,280000,-2000
1004995,7,62,280000,300000,20000
1004995,8,37,300000,316000,16000
1004995,9,63,316000,346000,30000
1004995,10,27,346000,352000,6000
1004995,11,28,352000,345000,-7000
1004995,12,11,345000,316000,-29000
1004995,13,54,316000,309000,-7000
1004995,14,NA,309000,309000,0
1004995,15,37,309000,305000,-4000
1004995,16,7,305000,285000,-20000
1004995,17,NA,285000,285000,0
1004995,18,46,285000,282000,-3000
1004995,19,35,282000,283000,1000
1004995,20,6,283000,263000,-20000
1004995,21,NA,263000,263000,0
1004995,22,NA,263000,263000,0
1004995,23,NA,263000,263000,0
1004995,24,NA,263000,263000,0
1004998,1,88,618000,630000,12000
1004998,2,56,630000,627000,-3000
1004998,3,43,627000,603000,-24000
1004998,4,61,603000,579000,-24000
1004998,5,65,579000,563000,-16000
1004998,6,12,563000,515000,-48000
1004998,7,NA,515000,515000,0
1004998,8,65,515000,490000,-25000
1004998,9,0,490000,436000,-54000
1004998,10,NA,436000,436000,0
1004998,11,NA,436000,436000,0
1004998,12,103,436000,439000,3000
1004998,13,68,439000,455000,16000
1004998,14,100,455000,505000,50000
1004998,15,NA,505000,505000,0
1004998,16,49,505000,529000,24000
1004998,17,71,529000,551000,22000
1004998,18,59,551000,553000,2000
1004998,19,58,553000,546000,-7000
1004998,20,46,546000,526000,-20000
1004998,21,87,526000,533000,7000
1004998,22,45,533000,524000,-9000
1004998,23,67,524000,523000,-1000
1004998,24,NA,523000,523000,0
1005000,1,NA,402000,402000,0
1005000,2,NA,402000,402000,0
1005000,3,NA,402000,402000,0
1005000,4,NA,402000,402000,0
1005000,5,NA,402000,402000,0
1005000,6,NA,402000,402000,0
1005000,7,NA,402000,402000,0
1005000,8,NA,402000,402000,0
1005000,9,NA,402000,402000,0
1005000,10,NA,402000,402000,0
1005000,11,NA,402000,402000,0
1005000,12,NA,402000,402000,0
1005000,13,74,402000,420000,18000
1005000,14,33,420000,424000,4000
1005000,15,NA,424000,424000,0
1005000,16,41,424000,418000,-6000
1005000,17,43,418000,409000,-9000
1005000,18,56,409000,407000,-2000
1005000,19,50,407000,406000,-1000
1005000,20,53,406000,412000,6000
1005000,21,80,412000,438000,26000
1005000,22,58,438000,458000,20000
1005000,23,46,458000,464000,6000
1005000,24,50,464000,461000,-3000
1005053,1,NA,542000,542000,0
1005053,2,NA,542000,542000,0
1005053,3,22,542000,511000,-31000
1005053,4,NA,511000,511000,0
1005053,5,NA,511000,511000,0
1005053,6,NA,511000,511000,0
1005053,7,31,511000,468000,-43000
1005053,8,76,468000,455000,-13000
1005053,9,24,455000,428000,-27000
1005053,10,NA,428000,428000,0
1005053,11,NA,428000,428000,0
1005053,12,NA,428000,428000,0
1005053,13,NA,428000,428000,0
1005053,14,NA,428000,428000,0
1005053,15,NA,428000,428000,0
1005053,16,NA,428000,428000,0
1005053,17,NA,428000,428000,0
1005053,18,NA,428000,428000,0
1005053,19,NA,428000,428000,0
1005053,20,NA,428000,428000,0
1005053,21,NA,428000,428000,0
1005053,22,NA,428000,428000,0
1005053,23,NA,428000,428000,0
1005053,24,NA,428000,428000,0
1005054,1,91,691000,699000,8000
1005054,2,96,699000,717000,18000
1005054,3,91,717000,734000,17000
1005054,4,76,734000,736000,2000
1005054,5,115,736000,758000,22000
1005054,6,108,758000,785000,27000
1005054,7,100,785000,806000,21000
1005054,8,73,806000,803000,-3000
1005054,9,92,803000,798000,-5000
1005054,10,115,798000,806000,8000
1005054,11,91,806000,807000,1000
1005054,12,80,807000,797000,-10000
1005054,13,66,797000,772000,-25000
1005054,14,NA,772000,772000,0
1005054,15,106,772000,768000,-4000
1005054,16,93,768000,766000,-2000
1005054,17,114,766000,783000,17000
1005054,18,120,783000,814000,31000
1005054,19,84,814000,826000,12000
1005054,20,84,826000,822000,-4000
1005054,21,65,822000,795000,-27000
1005054,22,124,795000,795000,0
1005054,23,98,795000,797000,2000
1005054,24,95,797000,798000,1000
1005107,1,21,397000,379000,-18000
1005107,2,37,379000,361000,-18000
1005107,3,42,361000,349000,-12000
1005107,4,73,349000,366000,17000
1005107,5,49,366000,383000,17000
1005107,6,NA,383000,383000,0
1005107,7,46,383000,397000,14000
1005107,8,46,397000,404000,7000
1005107,9,54,404000,412000,8000
1005107,10,29,412000,399000,-13000
1005107,11,29,399000,378000,-21000
1005107,12,79,378000,389000,11000
1005107,13,56,389000,403000,14000
1005107,14,NA,403000,403000,0
1005107,15,39,403000,408000,5000
1005107,16,52,408000,416000,8000
1005107,17,57,416000,425000,9000
1005107,18,38,425000,418000,-7000
1005107,19,40,418000,407000,-11000
1005107,20,44,407000,398000,-9000
1005107,21,39,398000,386000,-12000
1005107,22,39,386000,374000,-12000
1005107,23,19,374000,350000,-24000
1005107,24,NA,350000,350000,0
1005144,1,NA,443000,443000,0
1005144,2,65,443000,453000,10000
1005144,3,97,453000,492000,39000
1005144,4,NA,492000,492000,0
1005144,5,NA,492000,492000,0
1005144,6,NA,492000,492000,0
1005144,7,41,492000,506000,14000
1005144,8,NA,506000,506000,0
1005144,9,31,506000,493000,-13000
1005144,10,22,493000,456000,-37000
1005144,11,34,456000,416000,-40000
1005144,12,38,416000,381000,-35000
1005144,13,6,381000,336000,-45000
1005144,14,NA,336000,336000,0
1005144,15,NA,336000,336000,0
1005144,16,NA,336000,336000,0
1005144,17,NA,336000,336000,0
1005144,18,NA,336000,336000,0
1005144,19,NA,336000,336000,0
1005144,20,NA,336000,336000,0
1005144,21,NA,336000,336000,0
1005144,22,NA,336000,336000,0
1005144,23,NA,336000,336000,0
1005144,24,NA,336000,336000,0
1005150,1,NA,322000,322000,0
1005150,2,NA,322000,322000,0
1005150,3,NA,322000,322000,0
1005150,4,NA,322000,322000,0
1005150,5,NA,322000,322000,0
1005150,6,NA,322000,322000,0
1005150,7,NA,322000,322000,0
1005150,8,NA,322000,322000,0
1005150,9,NA,322000,322000,0
1005150,10,NA,322000,322000,0
1005150,11,NA,322000,322000,0
1005150,12,NA,322000,322000,0
1005150,13,NA,322000,322000,0
1005150,14,NA,322000,322000,0
1005150,15,NA,322000,322000,0
1005150,16,NA,322000,322000,0
1005150,17,NA,322000,322000,0
1005150,18,NA,322000,322000,0
1005150,19,NA,322000,322000,0
1005150,20,NA,322000,322000,0
1005150,21,NA,322000,322000,0
1005150,22,NA,322000,322000,0
1005150,23,NA,322000,322000,0
1005150,24,NA,322000,322000,0
1005199,1,62,445000,453000,8000
1005199,2,35,453000,446000,-7000
1005199,3,NA,446000,446000,0
1005199,4,NA,446000,446000,0
1005199,5,NA,446000,446000,0
1005199,6,NA,446000,446000,0
1005199,7,NA,446000,446000,0
1005199,8,NA,446000,446000,0
1005199,9,NA,446000,446000,0
1005199,10,41,446000,431000,-15000
1005199,11,NA,431000,431000,0
1005199,12,NA,431000,431000,0
1005199,13,NA,431000,431000,0
1005199,14,NA,431000,431000,0
1005199,15,NA,431000,431000,0
1005199,16,NA,431000,431000,0
1005199,17,NA,431000,431000,0
1005199,18,NA,431000,431000,0
1005199,19,NA,431000,431000,0
1005199,20,NA,431000,431000,0
1005199,21,NA,431000,431000,0
1005199,22,NA,431000,431000,0
1005199,23,NA,431000,431000,0
1005199,24,NA,431000,431000,0
1005247,1,40,599000,578000,-21000
1005247,2,59,578000,556000,-22000
1005247,3,55,556000,536000,-20000
1005247,4,59,536000,521000,-15000
1005247,5,77,521000,526000,5000
1005247,6,31,526000,511000,-15000
1005247,7,NA,511000,511000,0
1005247,8,NA,511000,511000,0
1005247,9,NA,511000,511000,0
1005247,10,NA,511000,511000,0
1005247,11,NA,511000,511000,0
1005247,12,NA,511000,511000,0
1005247,13,NA,511000,511000,0
1005247,14,31,511000,482000,-29000
1005247,15,NA,482000,482000,0
1005247,16,59,482000,464000,-18000
1005247,17,91,464000,479000,15000
1005247,18,90,479000,512000,33000
1005247,19,79,512000,549000,37000
1005247,20,79,549000,584000,35000
1005247,21,24,584000,571000,-13000
1005247,22,44,571000,540000,-31000
1005247,23,21,540000,488000,-52000
1005247,24,NA,488000,488000,0
1005326,1,NA,423000,423000,0
1005326,2,NA,423000,423000,0
1005326,3,NA,423000,423000,0
1005326,4,43,423000,417000,-6000
1005326,5,36,417000,404000,-13000
1005326,6,NA,404000,404000,0
1005326,7,NA,404000,404000,0
1005326,8,NA,404000,404000,0
1005326,9,45,404000,394000,-10000
1005326,10,26,394000,372000,-22000
1005326,11,55,372000,368000,-4000
1005326,12,NA,368000,368000,0
1005326,13,NA,368000,368000,0
1005326,14,NA,368000,368000,0
1005326,15,NA,368000,368000,0
1005326,16,NA,368000,368000,0
1005326,17,NA,368000,368000,0
1005326,18,17,368000,348000,-20000
1005326,19,NA,348000,348000,0
1005326,20,NA,348000,348000,0
1005326,21,29,348000,327000,-21000
1005326,22,NA,327000,327000,0
1005326,23,NA,327000,327000,0
1005326,24,NA,327000,327000,0
1005330,1,104,200000,260000,60000
1005330,2,64,260000,328000,68000
1005330,3,66,328000,393000,65000
1005330,4,64,393000,443000,50000
1005330,5,41,443000,460000,17000
1005330,6,59,460000,467000,7000
1005330,7,106,467000,505000,38000
1005330,8,37,505000,511000,6000
1005330,9,41,511000,501000,-10000
1005330,10,68,501000,501000,0
1005330,11,38,501000,483000,-18000
1005330,12,80,483000,485000,2000
1005330,13,62,485000,493000,8000
1005330,14,NA,493000,493000,0
1005330,15,52,493000,496000,3000
1005330,16,32,496000,479000,-17000
1005330,17,NA,479000,479000,0
1005330,18,NA,479000,479000,0
1005330,19,83,479000,486000,7000
1005330,20,47,486000,481000,-5000
1005330,21,81,481000,496000,15000
1005330,22,32,496000,487000,-9000
1005330,23,39,487000,469000,-18000
1005330,24,43,469000,445000,-24000
1005521,1,80,694000,694000,0
1005521,2,69,694000,686000,-8000
1005521,3,81,686000,681000,-5000
1005521,4,95,681000,689000,8000
1005521,5,50,689000,673000,-16000
1005521,6,85,673000,669000,-4000
1005521,7,71,669000,661000,-8000
1005521,8,85,661000,660000,-1000
1005521,9,88,660000,668000,8000
1005521,10,82,668000,676000,8000
1005521,11,103,676000,697000,21000
1005521,12,NA,697000,697000,0
1005521,13,52,697000,688000,-9000
1005521,14,134,688000,723000,35000
1005521,15,82,723000,739000,16000
1005521,16,57,739000,728000,-11000
1005521,17,95,728000,725000,-3000
1005521,18,94,725000,730000,5000
1005521,19,71,730000,718000,-12000
1005521,20,73,718000,704000,-14000
1005521,21,NA,704000,704000,0
1005521,22,83,704000,696000,-8000
1005521,23,106,696000,707000,11000
1005521,24,84,707000,711000,4000
1005547,1,NA,371000,371000,0
1005547,2,NA,371000,371000,0
1005547,3,NA,371000,371000,0
1005547,4,NA,371000,371000,0
1005547,5,NA,371000,371000,0
1005547,6,19,371000,353000,-18000
1005547,7,NA,353000,353000,0
1005547,8,NA,353000,353000,0
1005547,9,NA,353000,353000,0
1005547,10,NA,353000,353000,0
1005547,11,NA,353000,353000,0
1005547,12,NA,353000,353000,0
1005547,13,NA,353000,353000,0
1005547,14,NA,353000,353000,0
1005547,15,NA,353000,353000,0
1005547,16,NA,353000,353000,0
1005547,17,NA,353000,353000,0
1005547,18,NA,353000,353000,0
1005547,19,34,353000,334000,-19000
1005547,20,63,334000,339000,5000
1005547,21,31,339000,337000,-2000
1005547,22,29,337000,329000,-8000
1005547,23,NA,329000,329000,0
1005547,24,NA,329000,329000,0
1005577,1,47,524000,514000,-10000
1005577,2,65,514000,511000,-3000
1005577,3,76,511000,522000,11000
1005577,4,103,522000,559000,37000
1005577,5,82,559000,596000,37000
1005577,6,79,596000,626000,30000
1005577,7,41,626000,619000,-7000
1005577,8,84,619000,619000,0
1005577,9,54,619000,602000,-17000
1005577,10,71,602000,590000,-12000
1005577,11,62,590000,578000,-12000
1005577,12,71,578000,575000,-3000
1005577,13,41,575000,553000,-22000
1005577,14,NA,553000,553000,0
1005577,15,NA,553000,553000,0
1005577,16,NA,553000,553000,0
1005577,17,NA,553000,553000,0
1005577,18,NA,553000,553000,0
1005577,19,NA,553000,553000,0
1005577,20,NA,553000,553000,0
1005577,21,NA,553000,553000,0
1005577,22,NA,553000,553000,0
1005577,23,56,553000,534000,-19000
1005577,24,NA,534000,534000,0
1005599,1,NA,507000,507000,0
1005599,2,NA,507000,507000,0
1005599,3,NA,507000,507000,0
1005599,4,NA,507000,507000,0
1005599,5,NA,507000,507000,0
1005599,6,63,507000,509000,2000
1005599,7,34,509000,492000,-17000
1005599,8,30,492000,461000,-31000
1005599,9,56,461000,442000,-19000
1005599,10,71,442000,444000,2000
1005599,11,59,444000,452000,8000
1005599,12,57,452000,462000,10000
1005599,13,45,462000,463000,1000
1005599,14,NA,463000,463000,0
1005599,15,NA,463000,463000,0
1005599,16,NA,463000,463000,0
1005599,17,NA,463000,463000,0
1005599,18,NA,463000,463000,0
1005599,19,NA,463000,463000,0
1005599,20,NA,463000,463000,0
1005599,21,NA,463000,463000,0
1005599,22,76,463000,476000,13000
1005599,23,NA,476000,476000,0
1005599,24,NA,476000,476000,0
1005717,1,NA,379000,379000,0
1005717,2,NA,379000,379000,0
1005717,3,NA,379000,379000,0
1005717,4,NA,379000,379000,0
1005717,5,NA,379000,379000,0
1005717,6,NA,379000,379000,0
1005717,7,NA,379000,379000,0
1005717,8,NA,379000,379000,0
1005717,9,NA,379000,379000,0
1005717,10,NA,379000,379000,0
1005717,11,NA,379000,379000,0
1005717,12,NA,379000,379000,0
1005717,13,NA,379000,379000,0
1005717,14,NA,379000,379000,0
1005717,15,NA,379000,379000,0
1005717,16,NA,379000,379000,0
1005717,17,NA,379000,379000,0
1005717,18,NA,379000,379000,0
1005717,19,NA,379000,379000,0
1005717,20,NA,379000,379000,0
1005717,21,NA,379000,379000,0
1005717,22,NA,379000,379000,0
1005717,23,NA,379000,379000,0
1005717,24,NA,379000,379000,0
1005729,1,NA,475000,475000,0
1005729,2,NA,475000,475000,0
1005729,3,NA,475000,475000,0
1005729,4,NA,475000,475000,0
1005729,5,NA,475000,475000,0
1005729,6,NA,475000,475000,0
1005729,7,NA,475000,475000,0
1005729,8,NA,475000,475000,0
1005729,9,NA,475000,475000,0
1005729,10,NA,475000,475000,0
1005729,11,NA,475000,475000,0
1005729,12,82,475000,492000,17000
1005729,13,78,492000,518000,26000
1005729,14,66,518000,543000,25000
1005729,15,NA,543000,543000,0
1005729,16,82,543000,568000,25000
1005729,17,80,568000,591000,23000
1005729,18,61,591000,595000,4000
1005729,19,87,595000,608000,13000
1005729,20,54,608000,603000,-5000
1005729,21,82,603000,605000,2000
1005729,22,81,605000,612000,7000
1005729,23,105,612000,640000,28000
1005729,24,94,640000,667000,27000
1005986,1,NA,405000,405000,0
1005986,2,49,405000,406000,1000
1005986,3,36,406000,399000,-7000
1005986,4,37,399000,387000,-12000
1005986,5,40,387000,376000,-11000
1005986,6,18,376000,351000,-25000
1005986,7,39,351000,334000,-17000
1005986,8,55,334000,336000,2000
1005986,9,49,336000,345000,9000
1005986,10,35,345000,348000,3000
1005986,11,36,348000,348000,0
1005986,12,47,348000,350000,2000
1005986,13,NA,350000,350000,0
1005986,14,27,350000,342000,-8000
1005986,15,83,342000,366000,24000
1005986,16,45,366000,384000,18000
1005986,17,NA,384000,384000,0
1005986,18,NA,384000,384000,0
1005986,19,NA,384000,384000,0
1005986,20,36,384000,388000,4000
1005986,21,51,388000,393000,5000
1005986,22,66,393000,409000,16000
1005986,23,49,409000,416000,7000
1005986,24,60,416000,427000,11000
1005988,1,60,339000,354000,15000
1005988,2,73,354000,389000,35000
1005988,3,52,389000,417000,28000
1005988,4,56,417000,439000,22000
1005988,5,NA,439000,439000,0
1005988,6,NA,439000,439000,0
1005988,7,NA,439000,439000,0
1005988,8,NA,439000,439000,0
1005988,9,NA,439000,439000,0
1005988,10,NA,439000,439000,0
1005988,11,NA,439000,439000,0
1005988,12,NA,439000,439000,0
1005988,13,44,439000,442000,3000
1005988,14,72,442000,458000,16000
1005988,15,118,458000,510000,52000
1005988,16,116,510000,583000,73000
1005988,17,77,583000,634000,51000
1005988,18,75,634000,664000,30000
1005988,19,72,664000,673000,9000
1005988,20,74,673000,667000,-6000
1005988,21,87,667000,665000,-2000
1005988,22,84,665000,668000,3000
1005988,23,107,668000,691000,23000
1005988,24,61,691000,688000,-3000
1005992,1,46,418000,416000,-2000
1005992,2,71,416000,432000,16000
1005992,3,46,432000,440000,8000
1005992,4,31,440000,429000,-11000
1005992,5,NA,429000,429000,0
1005992,6,NA,429000,429000,0
1005992,7,NA,429000,429000,0
1005992,8,NA,429000,429000,0
1005992,9,NA,429000,429000,0
1005992,10,NA,429000,429000,0
1005992,11,61,429000,428000,-1000
1005992,12,75,428000,444000,16000
1005992,13,NA,444000,444000,0
1005992,14,30,444000,440000,-4000
1005992,15,NA,440000,440000,0
1005992,16,NA,440000,440000,0
1005992,17,NA,440000,440000,0
1005992,18,NA,440000,440000,0
1005992,19,NA,440000,440000,0
1005992,20,NA,440000,440000,0
1005992,21,NA,440000,440000,0
1005992,22,NA,440000,440000,0
1005992,23,NA,440000,440000,0
1005992,24,NA,440000,440000,0
1006013,1,42,440000,434000,-6000
1006013,2,46,434000,426000,-8000
1006013,3,44,426000,417000,-9000
1006013,4,NA,417000,417000,0
1006013,5,53,417000,415000,-2000
1006013,6,71,415000,431000,16000
1006013,7,70,431000,455000,24000
1006013,8,24,455000,450000,-5000
1006013,9,70,450000,458000,8000
1006013,10,28,458000,443000,-15000
1006013,11,32,443000,416000,-27000
1006013,12,NA,416000,416000,0
1006013,13,NA,416000,416000,0
1006013,14,NA,416000,416000,0
1006013,15,NA,416000,416000,0
1006013,16,NA,416000,416000,0
1006013,17,NA,416000,416000,0
1006013,18,NA,416000,416000,0
1006013,19,NA,416000,416000,0
1006013,20,NA,416000,416000,0
1006013,21,NA,416000,416000,0
1006013,22,NA,416000,416000,0
1006013,23,NA,416000,416000,0
1006013,24,NA,416000,416000,0
1006028,1,92,675000,685000,10000
1006028,2,81,685000,695000,10000
1006028,3,72,695000,694000,-1000
1006028,4,64,694000,680000,-14000
1006028,5,96,680000,683000,3000
1006028,6,65,683000,674000,-9000
1006028,7,43,674000,642000,-32000
1006028,8,77,642000,625000,-17000
1006028,9,74,625000,615000,-10000
1006028,10,64,615000,602000,-13000
1006028,11,114,602000,627000,25000
1006028,12,NA,627000,627000,0
1006028,13,74,627000,645000,18000
1006028,14,79,645000,661000,16000
1006028,15,73,661000,665000,4000
1006028,16,81,665000,669000,4000
1006028,17,58,669000,652000,-17000
1006028,18,63,652000,632000,-20000
1006028,19,44,632000,598000,-34000
1006028,20,60,598000,569000,-29000
1006028,21,39,569000,532000,-37000
1006028,22,95,532000,534000,2000
1006028,23,67,534000,540000,6000
1006028,24,67,540000,547000,7000
1006030,1,22,440000,419000,-21000
1006030,2,45,419000,401000,-18000
1006030,3,NA,401000,401000,0
1006030,4,NA,401000,401000,0
1006030,5,NA,401000,401000,0
1006030,6,NA,401000,401000,0
1006030,7,NA,401000,401000,0
1006030,8,NA,401000,401000,0
1006030,9,40,401000,384000,-17000
1006030,10,57,384000,382000,-2000
1006030,11,56,382000,391000,9000
1006030,12,33,391000,389000,-2000
1006030,13,48,389000,389000,0
1006030,14,NA,389000,389000,0
1006030,15,38,389000,384000,-5000
1006030,16,NA,384000,384000,0
1006030,17,NA,384000,384000,0
1006030,18,NA,384000,384000,0
1006030,19,NA,384000,384000,0
1006030,20,NA,384000,384000,0
1006030,21,67,384000,394000,10000
1006030,22,83,394000,425000,31000
1006030,23,61,425000,454000,29000
1006030,24,36,454000,457000,3000
1006058,1,76,612000,616000,4000
1006058,2,61,616000,612000,-4000
1006058,3,58,612000,599000,-13000
1006058,4,65,599000,587000,-12000
1006058,5,56,587000,571000,-16000
1006058,6,51,571000,550000,-21000
1006058,7,67,550000,540000,-10000
1006058,8,59,540000,532000,-8000
1006058,9,81,532000,541000,9000
1006058,10,121,541000,588000,47000
1006058,11,101,588000,641000,53000
1006058,12,80,641000,676000,35000
1006058,13,92,676000,705000,29000
1006058,14,83,705000,722000,17000
1006058,15,NA,722000,722000,0
1006058,16,104,722000,739000,17000
1006058,17,98,739000,754000,15000
1006058,18,136,754000,797000,43000
1006058,19,55,797000,795000,-2000
1006058,20,94,795000,793000,-2000
1006058,21,105,793000,797000,4000
1006058,22,95,797000,797000,0
1006058,23,103,797000,801000,4000
1006058,24,128,801000,828000,27000
1006059,1,57,688000,672000,-16000
1006059,2,NA,672000,672000,0
1006059,3,48,672000,637000,-35000
1006059,4,61,637000,604000,-33000
1006059,5,74,604000,588000,-16000
1006059,6,49,588000,567000,-21000
1006059,7,60,567000,551000,-16000
1006059,8,65,551000,545000,-6000
1006059,9,84,545000,555000,10000
1006059,10,48,555000,549000,-6000
1006059,11,64,549000,546000,-3000
1006059,12,NA,546000,546000,0
1006059,13,23,546000,514000,-32000
1006059,14,68,514000,501000,-13000
1006059,15,60,501000,492000,-9000
1006059,16,111,492000,527000,35000
1006059,17,77,527000,560000,33000
1006059,18,69,560000,585000,25000
1006059,19,105,585000,624000,39000
1006059,20,79,624000,649000,25000
1006059,21,NA,649000,649000,0
1006059,22,NA,649000,649000,0
1006059,23,97,649000,673000,24000
1006059,24,93,673000,694000,21000
1006087,1,NA,335000,335000,0
1006087,2,NA,335000,335000,0
1006087,3,NA,335000,335000,0
1006087,4,NA,335000,335000,0
1006087,5,NA,335000,335000,0
1006087,6,NA,335000,335000,0
1006087,7,NA,335000,335000,0
1006087,8,NA,335000,335000,0
1006087,9,NA,335000,335000,0
1006087,10,NA,335000,335000,0
1006087,11,NA,335000,335000,0
1006087,12,NA,335000,335000,0
1006087,13,NA,335000,335000,0
1006087,14,NA,335000,335000,0
1006087,15,NA,335000,335000,0
1006087,16,NA,335000,335000,0
1006087,17,NA,335000,335000,0
1006087,18,NA,335000,335000,0
1006087,19,NA,335000,335000,0
1006087,20,NA,335000,335000,0
1006087,21,NA,335000,335000,0
1006087,22,NA,335000,335000,0
1006087,23,NA,335000,335000,0
1006087,24,NA,335000,335000,0
1006094,1,NA,916000,916000,0
1006094,2,NA,916000,916000,0
1006094,3,NA,916000,916000,0
1006094,4,NA,916000,916000,0
1006094,5,102,916000,910000,-6000
1006094,6,131,910000,926000,16000
1006094,7,128,926000,950000,24000
1006094,8,109,950000,964000,14000
1006094,9,123,964000,978000,14000
1006094,10,90,978000,967000,-11000
1006094,11,112,967000,956000,-11000
1006094,12,55,956000,905000,-51000
1006094,13,91,905000,863000,-42000
1006094,14,82,863000,828000,-35000
1006094,15,NA,828000,828000,0
1006094,16,90,828000,802000,-26000
1006094,17,90,802000,784000,-18000
1006094,18,76,784000,766000,-18000
1006094,19,53,766000,729000,-37000
1006094,20,NA,729000,729000,0
1006094,21,NA,729000,729000,0
1006094,22,NA,729000,729000,0
1006094,23,NA,729000,729000,0
1006094,24,87,729000,704000,-25000
1006096,1,62,489000,493000,4000
1006096,2,47,493000,489000,-4000
1006096,3,37,489000,471000,-18000
1006096,4,86,471000,482000,11000
1006096,5,59,482000,492000,10000
1006096,6,71,492000,508000,16000
1006096,7,19,508000,490000,-18000
1006096,8,NA,490000,490000,0
1006096,9,NA,490000,490000,0
1006096,10,NA,490000,490000,0
1006096,11,NA,490000,490000,0
1006096,12,NA,490000,490000,0
1006096,13,NA,490000,490000,0
1006096,14,NA,490000,490000,0
1006096,15,NA,490000,490000,0
1006096,16,NA,490000,490000,0
1006096,17,NA,490000,490000,0
1006096,18,85,490000,497000,7000
1006096,19,75,497000,509000,12000
1006096,20,60,509000,518000,9000
1006096,21,70,518000,529000,11000
1006096,22,71,529000,544000,15000
1006096,23,81,544000,562000,18000
1006096,24,105,562000,596000,34000
1006100,1,NA,286000,286000,0
1006100,2,NA,286000,286000,0
1006100,3,NA,286000,286000,0
1006100,4,NA,286000,286000,0
1006100,5,NA,286000,286000,0
1006100,6,NA,286000,286000,0
1006100,7,NA,286000,286000,0
1006100,8,44,286000,293000,7000
1006100,9,50,293000,309000,16000
1006100,10,11,309000,302000,-7000
1006100,11,41,302000,300000,-2000
1006100,12,49,300000,307000,7000
1006100,13,NA,307000,307000,0
1006100,14,3,307000,289000,-18000
1006100,15,NA,289000,289000,0
1006100,16,NA,289000,289000,0
1006100,17,NA,289000,289000,0
1006100,18,NA,289000,289000,0
1006100,19,NA,289000,289000,0
1006100,20,NA,289000,289000,0
1006100,21,NA,289000,289000,0
1006100,22,NA,289000,289000,0
1006100,23,NA,289000,289000,0
1006100,24,NA,289000,289000,0
1006103,1,53,653000,637000,-16000
1006103,2,71,637000,623000,-14000
1006103,3,70,623000,612000,-11000
1006103,4,49,612000,590000,-22000
1006103,5,63,590000,574000,-16000
1006103,6,76,574000,572000,-2000
1006103,7,79,572000,580000,8000
1006103,8,77,580000,592000,12000
1006103,9,56,592000,592000,0
1006103,10,112,592000,620000,28000
1006103,11,74,620000,637000,17000
1006103,12,107,637000,668000,31000
1006103,13,92,668000,696000,28000
1006103,14,NA,696000,696000,0
1006103,15,69,696000,706000,10000
1006103,16,101,706000,721000,15000
1006103,17,82,721000,726000,5000
1006103,18,50,726000,701000,-25000
1006103,19,74,701000,678000,-23000
1006103,20,85,678000,668000,-10000
1006103,21,60,668000,648000,-20000
1006103,22,NA,648000,648000,0
1006103,23,78,648000,638000,-10000
1006103,24,NA,638000,638000,0
1006114,1,70,488000,498000,10000
1006114,2,51,498000,501000,3000
1006114,3,59,501000,503000,2000
1006114,4,79,503000,518000,15000
1006114,5,56,518000,524000,6000
1006114,6,101,524000,556000,32000
1006114,7,61,556000,573000,17000
1006114,8,94,573000,602000,29000
1006114,9,63,602000,612000,10000
1006114,10,104,612000,640000,28000
1006114,11,85,640000,660000,20000
1006114,12,87,660000,679000,19000
1006114,13,101,679000,703000,24000
1006114,14,NA,703000,703000,0
1006114,15,83,703000,719000,16000
1006114,16,121,719000,752000,33000
1006114,17,69,752000,757000,5000
1006114,18,67,757000,743000,-14000
1006114,19,85,743000,729000,-14000
1006114,20,104,729000,732000,3000
1006114,21,37,732000,698000,-34000
1006114,22,48,698000,655000,-43000
1006114,23,74,655000,626000,-29000
1006114,24,65,626000,599000,-27000
1006121,1,89,764000,765000,1000
1006121,2,59,765000,744000,-21000
1006121,3,60,744000,710000,-34000
1006121,4,83,710000,689000,-21000
1006121,5,110,689000,699000,10000
1006121,6,88,699000,712000,13000
1006121,7,82,712000,722000,10000
1006121,8,111,722000,748000,26000
1006121,9,118,748000,784000,36000
1006121,10,148,784000,842000,58000
1006121,11,101,842000,879000,37000
1006121,12,129,879000,918000,39000
1006121,13,121,918000,946000,28000
1006121,14,77,946000,941000,-5000
1006121,15,NA,941000,941000,0
1006121,16,102,941000,924000,-17000
1006121,17,86,924000,896000,-28000
1006121,18,68,896000,850000,-46000
1006121,19,105,850000,825000,-25000
1006121,20,83,825000,804000,-21000
1006121,21,130,804000,816000,12000
1006121,22,121,816000,844000,28000
1006121,23,113,844000,873000,29000
1006121,24,104,873000,886000,13000
1006126,1,84,726000,726000,0
1006126,2,59,726000,708000,-18000
1006126,3,53,708000,675000,-33000
1006126,4,85,675000,657000,-18000
1006126,5,73,657000,646000,-11000
1006126,6,78,646000,643000,-3000
1006126,7,75,643000,643000,0
1006126,8,75,643000,644000,1000
1006126,9,88,644000,653000,9000
1006126,10,62,653000,647000,-6000
1006126,11,94,647000,655000,8000
1006126,12,NA,655000,655000,0
1006126,13,77,655000,659000,4000
1006126,14,104,659000,684000,25000
1006126,15,129,684000,732000,48000
1006126,16,45,732000,734000,2000
1006126,17,77,734000,725000,-9000
1006126,18,93,725000,723000,-2000
1006126,19,87,723000,719000,-4000
1006126,20,64,719000,700000,-19000
1006126,21,98,700000,704000,4000
1006126,22,89,704000,709000,5000
1006126,23,74,709000,705000,-4000
1006126,24,60,705000,683000,-22000
1006127,1,NA,521000,521000,0
1006127,2,18,521000,489000,-32000
1006127,3,NA,489000,489000,0
1006127,4,NA,489000,489000,0
1006127,5,NA,489000,489000,0
1006127,6,NA,489000,489000,0
1006127,7,NA,489000,489000,0
1006127,8,NA,489000,489000,0
1006127,9,NA,489000,489000,0
1006127,10,NA,489000,489000,0
1006127,11,NA,489000,489000,0
1006127,12,NA,489000,489000,0
1006127,13,43,489000,455000,-34000
1006127,14,55,455000,437000,-18000
1006127,15,NA,437000,437000,0
1006127,16,24,437000,407000,-30000
1006127,17,62,407000,400000,-7000
1006127,18,59,400000,408000,8000
1006127,19,35,408000,405000,-3000
1006127,20,53,405000,406000,1000
1006127,21,67,406000,422000,16000
1006127,22,70,422000,443000,21000
1006127,23,43,443000,450000,7000
1006127,24,91,450000,479000,29000
1006130,1,96,935000,926000,-9000
1006130,2,105,926000,919000,-7000
1006130,3,71,919000,888000,-31000
1006130,4,83,888000,852000,-36000
1006130,5,NA,852000,852000,0
1006130,6,NA,852000,852000,0
1006130,7,90,852000,824000,-28000
1006130,8,105,824000,815000,-9000
1006130,9,102,815000,815000,0
1006130,10,121,815000,836000,21000
1006130,11,67,836000,828000,-8000
1006130,12,90,828000,816000,-12000
1006130,13,81,816000,795000,-21000
1006130,14,78,795000,775000,-20000
1006130,15,NA,775000,775000,0
1006130,16,51,775000,731000,-44000
1006130,17,43,731000,676000,-55000
1006130,18,NA,676000,676000,0
1006130,19,114,676000,666000,-10000
1006130,20,69,666000,656000,-10000
1006130,21,68,656000,646000,-10000
1006130,22,64,646000,634000,-12000
1006130,23,84,634000,634000,0
1006130,24,NA,634000,634000,0
1006133,1,19,553000,520000,-33000
1006133,2,NA,520000,520000,0
1006133,3,96,520000,522000,2000
1006133,4,NA,522000,522000,0
1006133,5,NA,522000,522000,0
1006133,6,NA,522000,522000,0
1006133,7,66,522000,527000,5000
1006133,8,65,527000,534000,7000
1006133,9,64,534000,541000,7000
1006133,10,103,541000,574000,33000
1006133,11,57,574000,584000,10000
1006133,12,60,584000,582000,-2000
1006133,13,69,582000,581000,-1000
1006133,14,71,581000,583000,2000
1006133,15,NA,583000,583000,0
1006133,16,88,583000,595000,12000
1006133,17,96,595000,622000,27000
1006133,18,57,622000,627000,5000
1006133,19,105,627000,652000,25000
1006133,20,61,652000,654000,2000
1006133,21,71,654000,649000,-5000
1006133,22,69,649000,638000,-11000
1006133,23,74,638000,630000,-8000
1006133,24,69,630000,617000,-13000
1006135,1,NA,360000,360000,0
1006135,2,NA,360000,360000,0
1006135,3,NA,360000,360000,0
1006135,4,NA,360000,360000,0
1006135,5,66,360000,377000,17000
1006135,6,90,377000,423000,46000
1006135,7,77,423000,473000,50000
1006135,8,51,473000,500000,27000
1006135,9,50,500000,507000,7000
1006135,10,55,507000,503000,-4000
1006135,11,36,503000,480000,-23000
1006135,12,87,480000,486000,6000
1006135,13,66,486000,497000,11000
1006135,14,56,497000,507000,10000
1006135,15,NA,507000,507000,0
1006135,16,66,507000,517000,10000
1006135,17,31,517000,501000,-16000
1006135,18,NA,501000,501000,0
1006135,19,NA,501000,501000,0
1006135,20,NA,501000,501000,0
1006135,21,NA,501000,501000,0
1006135,22,NA,501000,501000,0
1006135,23,NA,501000,501000,0
1006135,24,NA,501000,501000,0
1006136,1,NA,553000,553000,0
1006136,2,110,553000,586000,33000
1006136,3,69,586000,611000,25000
1006136,4,49,611000,610000,-1000
1006136,5,70,610000,607000,-3000
1006136,6,83,607000,612000,5000
1006136,7,73,612000,612000,0
1006136,8,51,612000,599000,-13000
1006136,9,107,599000,619000,20000
1006136,10,45,619000,610000,-9000
1006136,11,72,610000,604000,-6000
1006136,12,62,604000,593000,-11000
1006136,13,66,593000,583000,-10000
1006136,14,NA,583000,583000,0
1006136,15,33,583000,552000,-31000
1006136,16,82,552000,547000,-5000
1006136,17,59,547000,539000,-8000
1006136,18,53,539000,528000,-11000
1006136,19,NA,528000,528000,0
1006136,20,NA,528000,528000,0
1006136,21,NA,528000,528000,0
1006136,22,NA,528000,528000,0
1006136,23,NA,528000,528000,0
1006136,24,NA,528000,528000,0
1006137,1,77,573000,581000,8000
1006137,2,48,581000,573000,-8000
1006137,3,58,573000,561000,-12000
1006137,4,83,561000,565000,4000
1006137,5,58,565000,563000,-2000
1006137,6,77,563000,570000,7000
1006137,7,72,570000,580000,10000
1006137,8,56,580000,577000,-3000
1006137,9,48,577000,559000,-18000
1006137,10,NA,559000,559000,0
1006137,11,NA,559000,559000,0
1006137,12,NA,559000,559000,0
1006137,13,NA,559000,559000,0
1006137,14,NA,559000,559000,0
1006137,15,NA,559000,559000,0
1006137,16,NA,559000,559000,0
1006137,17,NA,559000,559000,0
1006137,18,81,559000,558000,-1000
1006137,19,44,558000,541000,-17000
1006137,20,57,541000,526000,-15000
1006137,21,82,526000,532000,6000
1006137,22,26,532000,511000,-21000
1006137,23,63,511000,499000,-12000
1006137,24,51,499000,485000,-14000
1006143,1,NA,551000,551000,0
1006143,2,NA,551000,551000,0
1006143,3,NA,551000,551000,0
1006143,4,NA,551000,551000,0
1006143,5,NA,551000,551000,0
1006143,6,NA,551000,551000,0
1006143,7,NA,551000,551000,0
1006143,8,NA,551000,551000,0
1006143,9,NA,551000,551000,0
1006143,10,83,551000,562000,11000
1006143,11,63,562000,568000,6000
1006143,12,NA,568000,568000,0
1006143,13,66,568000,571000,3000
1006143,14,58,571000,569000,-2000
1006143,15,18,569000,530000,-39000
1006143,16,77,530000,515000,-15000
1006143,17,0,515000,463000,-52000
1006143,18,NA,463000,463000,0
1006143,19,NA,463000,463000,0
1006143,20,NA,463000,463000,0
1006143,21,50,463000,428000,-35000
1006143,22,72,428000,423000,-5000
1006143,23,90,423000,453000,30000
1006143,24,NA,453000,453000,0
1006144,1,20,316000,304000,-12000
1006144,2,43,304000,301000,-3000
1006144,3,48,301000,309000,8000
1006144,4,18,309000,301000,-8000
1006144,5,27,301000,291000,-10000
1006144,6,78,291000,318000,27000
1006144,7,74,318000,360000,42000
1006144,8,31,360000,378000,18000
1006144,9,87,378000,420000,42000
1006144,10,60,420000,452000,32000
1006144,11,41,452000,458000,6000
1006144,12,72,458000,471000,13000
1006144,13,NA,471000,471000,0
1006144,14,44,471000,474000,3000
1006144,15,59,474000,473000,-1000
1006144,16,27,473000,453000,-20000
1006144,17,3,453000,404000,-49000
1006144,18,43,404000,369000,-35000
1006144,19,15,369000,328000,-41000
1006144,20,68,328000,325000,-3000
1006144,21,53,325000,338000,13000
1006144,22,NA,338000,338000,0
1006144,23,NA,338000,338000,0
1006144,24,NA,338000,338000,0
1006148,1,81,374000,402000,28000
1006148,2,40,402000,418000,16000
1006148,3,42,418000,423000,5000
1006148,4,69,423000,438000,15000
1006148,5,65,438000,456000,18000
1006148,6,29,456000,448000,-8000
1006148,7,31,448000,428000,-20000
1006148,8,15,428000,389000,-39000
1006148,9,75,389000,384000,-5000
1006148,10,33,384000,373000,-11000
1006148,11,73,373000,390000,17000
1006148,12,65,390000,417000,27000
1006148,13,40,417000,427000,10000
1006148,14,NA,427000,427000,0
1006148,15,39,427000,424000,-3000
1006148,16,60,424000,429000,5000
1006148,17,55,429000,431000,2000
1006148,18,15,431000,407000,-24000
1006148,19,40,407000,387000,-20000
1006148,20,NA,387000,387000,0
1006148,21,64,387000,388000,1000
1006148,22,75,388000,408000,20000
1006148,23,NA,408000,408000,0
1006148,24,47,408000,420000,12000
1006152,1,103,722000,737000,15000
1006152,2,71,737000,737000,0
1006152,3,66,737000,722000,-15000
1006152,4,76,722000,706000,-16000
1006152,5,57,706000,677000,-29000
1006152,6,72,677000,654000,-23000
1006152,7,70,654000,637000,-17000
1006152,8,76,637000,629000,-8000
1006152,9,76,629000,627000,-2000
1006152,10,78,627000,630000,3000
1006152,11,66,630000,627000,-3000
1006152,12,NA,627000,627000,0
1006152,13,55,627000,610000,-17000
1006152,14,95,610000,619000,9000
1006152,15,61,619000,615000,-4000
1006152,16,96,615000,630000,15000
1006152,17,98,630000,656000,26000
1006152,18,63,656000,663000,7000
1006152,19,41,663000,638000,-25000
1006152,20,70,638000,618000,-20000
1006152,21,67,618000,599000,-19000
1006152,22,114,599000,617000,18000
1006152,23,89,617000,642000,25000
1006152,24,99,642000,675000,33000
1006193,1,NA,200000,200000,0
1006193,2,NA,200000,200000,0
1006193,3,NA,200000,200000,0
1006193,4,NA,200000,200000,0
1006193,5,NA,200000,200000,0
1006193,6,NA,200000,200000,0
1006193,7,NA,200000,200000,0
1006193,8,NA,200000,200000,0
1006193,9,NA,200000,200000,0
1006193,10,NA,200000,200000,0
1006193,11,NA,200000,200000,0
1006193,12,NA,200000,200000,0
1006193,13,NA,200000,200000,0
1006193,14,NA,200000,200000,0
1006193,15,NA,200000,200000,0
1006193,16,NA,200000,200000,0
1006193,17,NA,200000,200000,0
1006193,18,NA,200000,200000,0
1006193,19,NA,200000,200000,0
1006193,20,NA,200000,200000,0
1006193,21,NA,200000,200000,0
1006193,22,NA,200000,200000,0
1006193,23,NA,200000,200000,0
1006193,24,NA,200000,200000,0
1006203,1,NA,428000,428000,0
1006203,2,NA,428000,428000,0
1006203,3,33,428000,415000,-13000
1006203,4,85,415000,432000,17000
1006203,5,108,432000,486000,54000
1006203,6,37,486000,508000,22000
1006203,7,90,508000,541000,33000
1006203,8,55,541000,555000,14000
1006203,9,83,555000,571000,16000
1006203,10,77,571000,583000,12000
1006203,11,62,583000,588000,5000
1006203,12,58,588000,580000,-8000
1006203,13,79,580000,582000,2000
1006203,14,NA,582000,582000,0
1006203,15,63,582000,579000,-3000
1006203,16,87,579000,591000,12000
1006203,17,78,591000,605000,14000
1006203,18,87,605000,624000,19000
1006203,19,60,624000,626000,2000
1006203,20,31,626000,596000,-30000
1006203,21,38,596000,551000,-45000
1006203,22,NA,551000,551000,0
1006203,23,NA,551000,551000,0
1006203,24,NA,551000,551000,0
1006232,1,NA,489000,489000,0
1006232,2,NA,489000,489000,0
1006232,3,NA,489000,489000,0
1006232,4,NA,489000,489000,0
1006232,5,NA,489000,489000,0
1006232,6,NA,489000,489000,0
1006232,7,NA,489000,489000,0
1006232,8,NA,489000,489000,0
1006232,9,NA,489000,489000,0
1006232,10,NA,489000,489000,0
1006232,11,72,489000,498000,9000
1006232,12,NA,498000,498000,0
1006232,13,44,498000,494000,-4000
1006232,14,34,494000,477000,-17000
1006232,15,NA,477000,477000,0
1006232,16,NA,477000,477000,0
1006232,17,NA,477000,477000,0
1006232,18,54,477000,461000,-16000
1006232,19,31,461000,435000,-26000
1006232,20,77,435000,436000,1000
1006232,21,66,436000,450000,14000
1006232,22,74,450000,475000,25000
1006232,23,55,475000,490000,15000
1006232,24,61,490000,499000,9000
1006303,1,30,200000,205000,5000
1006303,2,51,205000,229000,24000
1006303,3,45,229000,258000,29000
1006303,4,39,258000,283000,25000
1006303,5,75,283000,327000,44000
1006303,6,71,327000,377000,50000
1006303,7,18,377000,386000,9000
1006303,8,6,386000,361000,-25000
1006303,9,NA,361000,361000,0
1006303,10,NA,361000,361000,0
1006303,11,NA,361000,361000,0
1006303,12,NA,361000,361000,0
1006303,13,NA,361000,361000,0
1006303,14,NA,361000,361000,0
1006303,15,NA,361000,361000,0
1006303,16,68,361000,361000,0
1006303,17,45,361000,358000,-3000
1006303,18,25,358000,345000,-13000
1006303,19,NA,345000,345000,0
1006303,20,NA,345000,345000,0
1006303,21,NA,345000,345000,0
1006303,22,NA,345000,345000,0
1006303,23,NA,345000,345000,0
1006303,24,NA,345000,345000,0
1006314,1,86,826000,819000,-7000
1006314,2,109,819000,825000,6000
1006314,3,132,825000,856000,31000
1006314,4,66,856000,850000,-6000
1006314,5,85,850000,837000,-13000
1006314,6,82,837000,817000,-20000
1006314,7,66,817000,780000,-37000
1006314,8,82,780000,749000,-31000
1006314,9,64,749000,717000,-32000
1006314,10,79,717000,694000,-23000
1006314,11,126,694000,714000,20000
1006314,12,70,714000,718000,4000
1006314,13,106,718000,736000,18000
1006314,14,NA,736000,736000,0
1006314,15,74,736000,742000,6000
1006314,16,66,742000,728000,-14000
1006314,17,84,728000,714000,-14000
1006314,18,76,714000,700000,-14000
1006314,19,75,700000,685000,-15000
1006314,20,78,685000,675000,-10000
1006314,21,103,675000,688000,13000
1006314,22,107,688000,713000,25000
1006314,23,82,713000,728000,15000
1006314,24,127,728000,763000,35000
1006533,1,NA,339000,339000,0
1006533,2,57,339000,352000,13000
1006533,3,29,352000,352000,0
1006533,4,NA,352000,352000,0
1006533,5,NA,352000,352000,0
1006533,6,NA,352000,352000,0
1006533,7,NA,352000,352000,0
1006533,8,NA,352000,352000,0
1006533,9,NA,352000,352000,0
1006533,10,NA,352000,352000,0
1006533,11,NA,352000,352000,0
1006533,12,NA,352000,352000,0
1006533,13,NA,352000,352000,0
1006533,14,NA,352000,352000,0
1006533,15,NA,352000,352000,0
1006533,16,NA,352000,352000,0
1006533,17,NA,352000,352000,0
1006533,18,25,352000,340000,-12000
1006533,19,NA,340000,340000,0
1006533,20,NA,340000,340000,0
1006533,21,NA,340000,340000,0
1006533,22,NA,340000,340000,0
1006533,23,NA,340000,340000,0
1006533,24,NA,340000,340000,0
1006550,1,4,459000,423000,-36000
1006550,2,NA,423000,423000,0
1006550,3,NA,423000,423000,0
1006550,4,NA,423000,423000,0
1006550,5,41,423000,390000,-33000
1006550,6,60,390000,380000,-10000
1006550,7,51,380000,381000,1000
1006550,8,62,381000,397000,16000
1006550,9,52,397000,414000,17000
1006550,10,81,414000,447000,33000
1006550,11,40,447000,456000,9000
1006550,12,60,456000,464000,8000
1006550,13,80,464000,484000,20000
1006550,14,NA,484000,484000,0
1006550,15,70,484000,507000,23000
1006550,16,83,507000,536000,29000
1006550,17,55,536000,548000,12000
1006550,18,NA,548000,548000,0
1006550,19,49,548000,543000,-5000
1006550,20,50,543000,526000,-17000
1006550,21,58,526000,511000,-15000
1006550,22,NA,511000,511000,0
1006550,23,30,511000,479000,-32000
1006550,24,42,479000,449000,-30000
1006576,1,NA,369000,369000,0
1006576,2,NA,369000,369000,0
1006576,3,NA,369000,369000,0
1006576,4,48,369000,371000,2000
1006576,5,56,371000,383000,12000
1006576,6,47,383000,393000,10000
1006576,7,46,393000,398000,5000
1006576,8,66,398000,415000,17000
1006576,9,56,415000,429000,14000
1006576,10,NA,429000,429000,0
1006576,11,12,429000,409000,-20000
1006576,12,NA,409000,409000,0
1006576,13,35,409000,387000,-22000
1006576,14,NA,387000,387000,0
1006576,15,29,387000,361000,-26000
1006576,16,NA,361000,361000,0
1006576,17,NA,361000,361000,0
1006576,18,NA,361000,361000,0
1006576,19,NA,361000,361000,0
1006576,20,57,361000,353000,-8000
1006576,21,80,353000,377000,24000
1006576,22,45,377000,396000,19000
1006576,23,62,396000,419000,23000
1006576,24,21,419000,412000,-7000
1007099,1,NA,225000,225000,0
1007099,2,NA,225000,225000,0
1007099,3,NA,225000,225000,0
1007099,4,NA,225000,225000,0
1007099,5,NA,225000,225000,0
1007099,6,NA,225000,225000,0
1007099,7,NA,225000,225000,0
1007099,8,56,225000,246000,21000
1007099,9,70,246000,290000,44000
1007099,10,52,290000,332000,42000
1007099,11,NA,332000,332000,0
1007099,12,NA,332000,332000,0
1007099,13,NA,332000,332000,0
1007099,14,NA,332000,332000,0
1007099,15,NA,332000,332000,0
1007099,16,NA,332000,332000,0
1007099,17,NA,332000,332000,0
1007099,18,NA,332000,332000,0
1007099,19,NA,332000,332000,0
1007099,20,NA,332000,332000,0
1007099,21,NA,332000,332000,0
1007099,22,NA,332000,332000,0
1007099,23,NA,332000,332000,0
1007099,24,NA,332000,332000,0
1007102,1,65,501000,506000,5000
1007102,2,37,506000,495000,-11000
1007102,3,63,495000,490000,-5000
1007102,4,63,490000,492000,2000
1007102,5,50,492000,488000,-4000
1007102,6,75,488000,499000,11000
1007102,7,68,499000,514000,15000
1007102,8,77,514000,534000,20000
1007102,9,52,534000,539000,5000
1007102,10,45,539000,527000,-12000
1007102,11,54,527000,512000,-15000
1007102,12,35,512000,483000,-29000
1007102,13,NA,483000,483000,0
1007102,14,79,483000,483000,0
1007102,15,59,483000,486000,3000
1007102,16,NA,486000,486000,0
1007102,17,72,486000,499000,13000
1007102,18,72,499000,518000,19000
1007102,19,84,518000,546000,28000
1007102,20,42,546000,545000,-1000
1007102,21,37,545000,524000,-21000
1007102,22,69,524000,514000,-10000
1007102,23,90,514000,526000,12000
1007102,24,74,526000,540000,14000
1007124,1,41,549000,533000,-16000
1007124,2,62,533000,521000,-12000
1007124,3,92,521000,537000,16000
1007124,4,38,537000,530000,-7000
1007124,5,104,530000,557000,27000
1007124,6,95,557000,598000,41000
1007124,7,65,598000,618000,20000
1007124,8,97,618000,645000,27000
1007124,9,81,645000,666000,21000
1007124,10,130,666000,710000,44000
1007124,11,98,710000,746000,36000
1007124,12,69,746000,754000,8000
1007124,13,102,754000,765000,11000
1007124,14,NA,765000,765000,0
1007124,15,80,765000,764000,-1000
1007124,16,52,764000,733000,-31000
1007124,17,90,733000,715000,-18000
1007124,18,100,715000,716000,1000
1007124,19,64,716000,702000,-14000
1007124,20,53,702000,674000,-28000
1007124,21,125,674000,691000,17000
1007124,22,86,691000,703000,12000
1007124,23,91,703000,716000,13000
1007124,24,72,716000,714000,-2000
1007238,1,NA,288000,288000,0
1007238,2,NA,288000,288000,0
1007238,3,NA,288000,288000,0
1007238,4,NA,288000,288000,0
1007238,5,NA,288000,288000,0
1007238,6,NA,288000,288000,0
1007238,7,NA,288000,288000,0
1007238,8,NA,288000,288000,0
1007238,9,NA,288000,288000,0
1007238,10,NA,288000,288000,0
1007238,11,NA,288000,288000,0
1007238,12,NA,288000,288000,0
1007238,13,NA,288000,288000,0
1007238,14,NA,288000,288000,0
1007238,15,NA,288000,288000,0
1007238,16,NA,288000,288000,0
1007238,17,NA,288000,288000,0
1007238,18,NA,288000,288000,0
1007238,19,NA,288000,288000,0
1007238,20,NA,288000,288000,0
1007238,21,NA,288000,288000,0
1007238,22,NA,288000,288000,0
1007238,23,NA,288000,288000,0
1007238,24,NA,288000,288000,0
1007591,1,NA,380000,380000,0
1007591,2,NA,380000,380000,0
1007591,3,NA,380000,380000,0
1007591,4,NA,380000,380000,0
1007591,5,NA,380000,380000,0
1007591,6,74,380000,401000,21000
1007591,7,60,401000,425000,24000
1007591,8,48,425000,440000,15000
1007591,9,53,440000,449000,9000
1007591,10,NA,449000,449000,0
1007591,11,NA,449000,449000,0
1007591,12,NA,449000,449000,0
1007591,13,NA,449000,449000,0
1007591,14,NA,449000,449000,0
1007591,15,NA,449000,449000,0
1007591,16,NA,449000,449000,0
1007591,17,NA,449000,449000,0
1007591,18,NA,449000,449000,0
1007591,19,NA,449000,449000,0
1007591,20,NA,449000,449000,0
1007591,21,NA,449000,449000,0
1007591,22,NA,449000,449000,0
1007591,23,NA,449000,449000,0
1007591,24,NA,449000,449000,0
1007881,1,NA,530000,530000,0
1007881,2,NA,530000,530000,0
1007881,3,51,530000,521000,-9000
1007881,4,86,521000,533000,12000
1007881,5,49,533000,532000,-1000
1007881,6,79,532000,545000,13000
1007881,7,127,545000,597000,52000
1007881,8,105,597000,656000,59000
1007881,9,79,656000,691000,35000
1007881,10,67,691000,702000,11000
1007881,11,44,702000,676000,-26000
1007881,12,55,676000,635000,-41000
1007881,13,NA,635000,635000,0
1007881,14,70,635000,608000,-27000
1007881,15,100,608000,612000,4000
1007881,16,105,612000,642000,30000
1007881,17,63,642000,655000,13000
1007881,18,118,655000,693000,38000
1007881,19,99,693000,726000,33000
1007881,20,89,726000,745000,19000
1007881,21,92,745000,757000,12000
1007881,22,NA,757000,757000,0
1007881,23,NA,757000,757000,0
1007881,24,NA,757000,757000,0
1008083,1,63,491000,496000,5000
1008083,2,61,496000,502000,6000
1008083,3,47,502000,498000,-4000
1008083,4,72,498000,504000,6000
1008083,5,103,504000,541000,37000
1008083,6,69,541000,568000,27000
1008083,7,62,568000,581000,13000
1008083,8,96,581000,608000,27000
1008083,9,61,608000,615000,7000
1008083,10,55,615000,602000,-13000
1008083,11,78,602000,599000,-3000
1008083,12,55,599000,585000,-14000
1008083,13,40,585000,554000,-31000
1008083,14,81,554000,551000,-3000
1008083,15,NA,551000,551000,0
1008083,16,54,551000,542000,-9000
1008083,17,82,542000,548000,6000
1008083,18,69,548000,557000,9000
1008083,19,94,557000,584000,27000
1008083,20,63,584000,595000,11000
1008083,21,30,595000,573000,-22000
1008083,22,64,573000,554000,-19000
1008083,23,82,554000,552000,-2000
1008083,24,59,552000,543000,-9000
1008089,1,37,522000,505000,-17000
1008089,2,57,505000,492000,-13000
1008089,3,58,492000,484000,-8000
1008089,4,75,484000,493000,9000
1008089,5,69,493000,509000,16000
1008089,6,42,509000,509000,0
1008089,7,55,509000,504000,-5000
1008089,8,89,504000,521000,17000
1008089,9,55,521000,525000,4000
1008089,10,48,525000,518000,-7000
1008089,11,74,518000,524000,6000
1008089,12,92,524000,547000,23000
1008089,13,87,547000,576000,29000
1008089,14,NA,576000,576000,0
1008089,15,87,576000,610000,34000
1008089,16,76,610000,635000,25000
1008089,17,118,635000,677000,42000
1008089,18,81,677000,700000,23000
1008089,19,47,700000,687000,-13000
1008089,20,25,687000,637000,-50000
1008089,21,79,637000,607000,-30000
1008089,22,88,607000,596000,-11000
1008089,23,43,596000,573000,-23000
1008089,24,94,573000,580000,7000
1008091,1,NA,458000,458000,0
1008091,2,91,458000,485000,27000
1008091,3,62,485000,510000,25000
1008091,4,29,510000,503000,-7000
1008091,5,37,503000,481000,-22000
1008091,6,NA,481000,481000,0
1008091,7,NA,481000,481000,0
1008091,8,NA,481000,481000,0
1008091,9,NA,481000,481000,0
1008091,10,NA,481000,481000,0
1008091,11,NA,481000,481000,0
1008091,12,NA,481000,481000,0
1008091,13,12,481000,432000,-49000
1008091,14,61,432000,408000,-24000
1008091,15,59,408000,402000,-6000
1008091,16,44,402000,401000,-1000
1008091,17,NA,401000,401000,0
1008091,18,80,401000,426000,25000
1008091,19,30,426000,429000,3000
1008091,20,91,429000,457000,28000
1008091,21,34,457000,459000,2000
1008091,22,37,459000,447000,-12000
1008091,23,NA,447000,447000,0
1008091,24,44,447000,429000,-18000
1008123,1,44,527000,515000,-12000
1008123,2,33,515000,486000,-29000
1008123,3,67,486000,475000,-11000
1008123,4,46,475000,462000,-13000
1008123,5,NA,462000,462000,0
1008123,6,NA,462000,462000,0
1008123,7,NA,462000,462000,0
1008123,8,NA,462000,462000,0
1008123,9,NA,462000,462000,0
1008123,10,45,462000,448000,-14000
1008123,11,69,448000,453000,5000
1008123,12,51,453000,456000,3000
1008123,13,67,456000,465000,9000
1008123,14,103,465000,509000,44000
1008123,15,NA,509000,509000,0
1008123,16,34,509000,518000,9000
1008123,17,86,518000,538000,20000
1008123,18,37,538000,531000,-7000
1008123,19,38,531000,506000,-25000
1008123,20,67,506000,492000,-14000
1008123,21,31,492000,467000,-25000
1008123,22,74,467000,464000,-3000
1008123,23,44,464000,457000,-7000
1008123,24,46,457000,447000,-10000
1008139,1,NA,358000,358000,0
1008139,2,NA,358000,358000,0
1008139,3,NA,358000,358000,0
1008139,4,NA,358000,358000,0
1008139,5,NA,358000,358000,0
1008139,6,NA,358000,358000,0
1008139,7,32,358000,350000,-8000
1008139,8,77,350000,370000,20000
1008139,9,29,370000,374000,4000
1008139,10,44,374000,375000,1000
1008139,11,73,375000,397000,22000
1008139,12,92,397000,441000,44000
1008139,13,87,441000,491000,50000
1008139,14,59,491000,527000,36000
1008139,15,NA,527000,527000,0
1008139,16,45,527000,534000,7000
1008139,17,54,534000,527000,-7000
1008139,18,57,527000,513000,-14000
1008139,19,49,513000,495000,-18000
1008139,20,78,495000,499000,4000
1008139,21,81,499000,520000,21000
1008139,22,NA,520000,520000,0
1008139,23,79,520000,545000,25000
1008139,24,83,545000,572000,27000
1008154,1,NA,533000,533000,0
1008154,2,NA,533000,533000,0
1008154,3,NA,533000,533000,0
1008154,4,NA,533000,533000,0
1008154,5,NA,533000,533000,0
1008154,6,NA,533000,533000,0
1008154,7,NA,533000,533000,0
1008154,8,NA,533000,533000,0
1008154,9,65,533000,533000,0
1008154,10,36,533000,514000,-19000
1008154,11,97,514000,528000,14000
1008154,12,50,528000,527000,-1000
1008154,13,54,527000,521000,-6000
1008154,14,95,521000,545000,24000
1008154,15,NA,545000,545000,0
1008154,16,NA,545000,545000,0
1008154,17,65,545000,559000,14000
1008154,18,52,559000,555000,-4000
1008154,19,66,555000,553000,-2000
1008154,20,56,553000,545000,-8000
1008154,21,69,545000,540000,-5000
1008154,22,56,540000,533000,-7000
1008154,23,49,533000,519000,-14000
1008154,24,62,519000,509000,-10000
1008159,1,NA,342000,342000,0
1008159,2,NA,342000,342000,0
1008159,3,NA,342000,342000,0
1008159,4,NA,342000,342000,0
1008159,5,NA,342000,342000,0
1008159,6,NA,342000,342000,0
1008159,7,NA,342000,342000,0
1008159,8,NA,342000,342000,0
1008159,9,NA,342000,342000,0
1008159,10,NA,342000,342000,0
1008159,11,NA,342000,342000,0
1008159,12,NA,342000,342000,0
1008159,13,NA,342000,342000,0
1008159,14,NA,342000,342000,0
1008159,15,NA,342000,342000,0
1008159,16,NA,342000,342000,0
1008159,17,NA,342000,342000,0
1008159,18,NA,342000,342000,0
1008159,19,NA,342000,342000,0
1008159,20,NA,342000,342000,0
1008159,21,NA,342000,342000,0
1008159,22,NA,342000,342000,0
1008159,23,NA,342000,342000,0
1008159,24,NA,342000,342000,0
1008171,1,12,416000,389000,-27000
1008171,2,NA,389000,389000,0
1008171,3,NA,389000,389000,0
1008171,4,NA,389000,389000,0
1008171,5,NA,389000,389000,0
1008171,6,NA,389000,389000,0
1008171,7,NA,389000,389000,0
1008171,8,NA,389000,389000,0
1008171,9,NA,389000,389000,0
1008171,10,NA,389000,389000,0
1008171,11,NA,389000,389000,0
1008171,12,NA,389000,389000,0
1008171,13,NA,389000,389000,0
1008171,14,NA,389000,389000,0
1008171,15,NA,389000,389000,0
1008171,16,NA,389000,389000,0
1008171,17,NA,389000,389000,0
1008171,18,NA,389000,389000,0
1008171,19,NA,389000,389000,0
1008171,20,NA,389000,389000,0
1008171,21,NA,389000,389000,0
1008171,22,NA,389000,389000,0
1008171,23,NA,389000,389000,0
1008171,24,NA,389000,389000,0
1008185,1,NA,456000,456000,0
1008185,2,NA,456000,456000,0
1008185,3,NA,456000,456000,0
1008185,4,58,456000,458000,2000
1008185,5,30,458000,443000,-15000
1008185,6,3,443000,398000,-45000
1008185,7,NA,398000,398000,0
1008185,8,NA,398000,398000,0
1008185,9,46,398000,369000,-29000
1008185,10,NA,369000,369000,0
1008185,11,64,369000,365000,-4000
1008185,12,59,365000,376000,11000
1008185,13,48,376000,389000,13000
1008185,14,NA,389000,389000,0
1008185,15,58,389000,410000,21000
1008185,16,49,410000,422000,12000
1008185,17,67,422000,438000,16000
1008185,18,8,438000,415000,-23000
1008185,19,NA,415000,415000,0
1008185,20,NA,415000,415000,0
1008185,21,NA,415000,415000,0
1008185,22,NA,415000,415000,0
1008185,23,NA,415000,415000,0
1008185,24,NA,415000,415000,0
1008198,1,72,358000,381000,23000
1008198,2,46,381000,399000,18000
1008198,3,60,399000,420000,21000
1008198,4,10,420000,404000,-16000
1008198,5,NA,404000,404000,0
1008198,6,NA,404000,404000,0
1008198,7,31,404000,379000,-25000
1008198,8,44,379000,361000,-18000
1008198,9,NA,361000,361000,0
1008198,10,NA,361000,361000,0
1008198,11,NA,361000,361000,0
1008198,12,NA,361000,361000,0
1008198,13,NA,361000,361000,0
1008198,14,NA,361000,361000,0
1008198,15,NA,361000,361000,0
1008198,16,NA,361000,361000,0
1008198,17,40,361000,348000,-13000
1008198,18,67,348000,360000,12000
1008198,19,26,360000,359000,-1000
1008198,20,54,359000,368000,9000
1008198,21,35,368000,366000,-2000
1008198,22,49,366000,368000,2000
1008198,23,48,368000,371000,3000
1008198,24,58,371000,382000,11000
1008230,1,27,298000,293000,-5000
1008230,2,55,293000,304000,11000
1008230,3,48,304000,322000,18000
1008230,4,34,322000,330000,8000
1008230,5,45,330000,340000,10000
1008230,6,30,340000,338000,-2000
1008230,7,64,338000,352000,14000
1008230,8,20,352000,345000,-7000
1008230,9,NA,345000,345000,0
1008230,10,63,345000,357000,12000
1008230,11,37,357000,360000,3000
1008230,12,32,360000,354000,-6000
1008230,13,27,354000,338000,-16000
1008230,14,NA,338000,338000,0
1008230,15,5,338000,306000,-32000
1008230,16,30,306000,279000,-27000
1008230,17,44,279000,272000,-7000
1008230,18,63,272000,291000,19000
1008230,19,55,291000,320000,29000
1008230,20,NA,320000,320000,0
1008230,21,NA,320000,320000,0
1008230,22,NA,320000,320000,0
1008230,23,NA,320000,320000,0
1008230,24,NA,320000,320000,0
1008239,1,NA,206000,206000,0
1008239,2,NA,206000,206000,0
1008239,3,NA,206000,206000,0
1008239,4,NA,206000,206000,0
1008239,5,NA,206000,206000,0
1008239,6,NA,206000,206000,0
1008239,7,NA,206000,206000,0
1008239,8,NA,206000,206000,0
1008239,9,NA,206000,206000,0
1008239,10,NA,206000,206000,0
1008239,11,NA,206000,206000,0
1008239,12,NA,206000,206000,0
1008239,13,NA,206000,206000,0
1008239,14,NA,206000,206000,0
1008239,15,NA,206000,206000,0
1008239,16,NA,206000,206000,0
1008239,17,NA,206000,206000,0
1008239,18,NA,206000,206000,0
1008239,19,NA,206000,206000,0
1008239,20,NA,206000,206000,0
1008239,21,NA,206000,206000,0
1008239,22,NA,206000,206000,0
1008239,23,NA,206000,206000,0
1008239,24,NA,206000,206000,0
1008280,1,89,648000,659000,11000
1008280,2,72,659000,663000,4000
1008280,3,103,663000,685000,22000
1008280,4,91,685000,706000,21000
1008280,5,80,706000,717000,11000
1008280,6,47,717000,697000,-20000
1008280,7,77,697000,679000,-18000
1008280,8,87,679000,671000,-8000
1008280,9,105,671000,684000,13000
1008280,10,68,684000,686000,2000
1008280,11,57,686000,672000,-14000
1008280,12,54,672000,644000,-28000
1008280,13,NA,644000,644000,0
1008280,14,NA,644000,644000,0
1008280,15,NA,644000,644000,0
1008280,16,NA,644000,644000,0
1008280,17,84,644000,631000,-13000
1008280,18,108,631000,645000,14000
1008280,19,73,645000,655000,10000
1008280,20,NA,655000,655000,0
1008280,21,75,655000,662000,7000
1008280,22,79,662000,666000,4000
1008280,23,80,666000,667000,1000
1008280,24,88,667000,669000,2000
1008282,1,39,527000,511000,-16000
1008282,2,NA,511000,511000,0
1008282,3,NA,511000,511000,0
1008282,4,NA,511000,511000,0
1008282,5,47,511000,489000,-22000
1008282,6,NA,489000,489000,0
1008282,7,72,489000,486000,-3000
1008282,8,53,486000,482000,-4000
1008282,9,64,482000,487000,5000
1008282,10,64,487000,496000,9000
1008282,11,66,496000,507000,11000
1008282,12,52,507000,506000,-1000
1008282,13,49,506000,497000,-9000
1008282,14,NA,497000,497000,0
1008282,15,NA,497000,497000,0
1008282,16,37,497000,477000,-20000
1008282,17,34,477000,447000,-30000
1008282,18,NA,447000,447000,0
1008282,19,50,447000,426000,-21000
1008282,20,74,426000,432000,6000
1008282,21,32,432000,424000,-8000
1008282,22,75,424000,438000,14000
1008282,23,NA,438000,438000,0
1008282,24,NA,438000,438000,0
1008285,1,NA,200000,200000,0
1008285,2,NA,200000,200000,0
1008285,3,NA,200000,200000,0
1008285,4,NA,200000,200000,0
1008285,5,NA,200000,200000,0
1008285,6,24,200000,200000,0
1008285,7,34,200000,208000,8000
1008285,8,NA,208000,208000,0
1008285,9,NA,208000,208000,0
1008285,10,NA,208000,208000,0
1008285,11,NA,208000,208000,0
1008285,12,NA,208000,208000,0
1008285,13,NA,208000,208000,0
1008285,14,NA,208000,208000,0
1008285,15,NA,208000,208000,0
1008285,16,NA,208000,208000,0
1008285,17,NA,208000,208000,0
1008285,18,NA,208000,208000,0
1008285,19,NA,208000,208000,0
1008285,20,NA,208000,208000,0
1008285,21,NA,208000,208000,0
1008285,22,NA,208000,208000,0
1008285,23,NA,208000,208000,0
1008285,24,NA,208000,208000,0
1008312,1,81,441000,463000,22000
1008312,2,98,463000,512000,49000
1008312,3,55,512000,541000,29000
1008312,4,88,541000,575000,34000
1008312,5,64,575000,591000,16000
1008312,6,58,591000,590000,-1000
1008312,7,65,590000,582000,-8000
1008312,8,127,582000,620000,38000
1008312,9,68,620000,638000,18000
1008312,10,93,638000,663000,25000
1008312,11,64,663000,669000,6000
1008312,12,NA,669000,669000,0
1008312,13,62,669000,657000,-12000
1008312,14,56,657000,633000,-24000
1008312,15,87,633000,626000,-7000
1008312,16,27,626000,589000,-37000
1008312,17,72,589000,569000,-20000
1008312,18,43,569000,541000,-28000
1008312,19,NA,541000,541000,0
1008312,20,76,541000,534000,-7000
1008312,21,32,534000,508000,-26000
1008312,22,95,508000,519000,11000
1008312,23,78,519000,538000,19000
1008312,24,63,538000,549000,11000
1008384,1,NA,507000,507000,0
1008384,2,41,507000,494000,-13000
1008384,3,74,494000,496000,2000
1008384,4,92,496000,523000,27000
1008384,5,43,523000,528000,5000
1008384,6,51,528000,524000,-4000
1008384,7,66,524000,524000,0
1008384,8,21,524000,493000,-31000
1008384,9,40,493000,458000,-35000
1008384,10,NA,458000,458000,0
1008384,11,67,458000,448000,-10000
1008384,12,55,448000,444000,-4000
1008384,13,70,444000,455000,11000
1008384,14,NA,455000,455000,0
1008384,15,58,455000,471000,16000
1008384,16,79,471000,497000,26000
1008384,17,43,497000,500000,3000
1008384,18,52,500000,495000,-5000
1008384,19,44,495000,480000,-15000
1008384,20,53,480000,467000,-13000
1008384,21,75,467000,472000,5000
1008384,22,39,472000,465000,-7000
1008384,23,18,465000,436000,-29000
1008384,24,29,436000,400000,-36000
1008436,1,NA,469000,469000,0
1008436,2,NA,469000,469000,0
1008436,3,NA,469000,469000,0
1008436,4,NA,469000,469000,0
1008436,5,NA,469000,469000,0
1008436,6,NA,469000,469000,0
1008436,7,NA,469000,469000,0
1008436,8,NA,469000,469000,0
1008436,9,NA,469000,469000,0
1008436,10,84,469000,488000,19000
1008436,11,111,488000,540000,52000
1008436,12,117,540000,612000,72000
1008436,13,101,612000,677000,65000
1008436,14,97,677000,729000,52000
1008436,15,NA,729000,729000,0
1008436,16,59,729000,736000,7000
1008436,17,95,736000,738000,2000
1008436,18,86,738000,734000,-4000
1008436,19,73,734000,721000,-13000
1008436,20,130,721000,744000,23000
1008436,21,114,744000,780000,36000
1008436,22,75,780000,789000,9000
1008436,23,93,789000,793000,4000
1008436,24,82,793000,783000,-10000
1008454,1,NA,561000,561000,0
1008454,2,NA,561000,561000,0
1008454,3,NA,561000,561000,0
1008454,4,NA,561000,561000,0
1008454,5,NA,561000,561000,0
1008454,6,NA,561000,561000,0
1008454,7,NA,561000,561000,0
1008454,8,NA,561000,561000,0
1008454,9,NA,561000,561000,0
1008454,10,NA,561000,561000,0
1008454,11,NA,561000,561000,0
1008454,12,NA,561000,561000,0
1008454,13,NA,561000,561000,0
1008454,14,NA,561000,561000,0
1008454,15,NA,561000,561000,0
1008454,16,NA,561000,561000,0
1008454,17,NA,561000,561000,0
1008454,18,NA,561000,561000,0
1008454,19,NA,561000,561000,0
1008454,20,NA,561000,561000,0
1008454,21,NA,561000,561000,0
1008454,22,NA,561000,561000,0
1008454,23,64,561000,558000,-3000
1008454,24,83,558000,566000,8000
1008460,1,NA,200000,200000,0
1008460,2,NA,200000,200000,0
1008460,3,NA,200000,200000,0
1008460,4,NA,200000,200000,0
1008460,5,NA,200000,200000,0
1008460,6,NA,200000,200000,0
1008460,7,NA,200000,200000,0
1008460,8,NA,200000,200000,0
1008460,9,NA,200000,200000,0
1008460,10,NA,200000,200000,0
1008460,11,NA,200000,200000,0
1008460,12,NA,200000,200000,0
1008460,13,NA,200000,200000,0
1008460,14,NA,200000,200000,0
1008460,15,NA,200000,200000,0
1008460,16,NA,200000,200000,0
1008460,17,NA,200000,200000,0
1008460,18,NA,200000,200000,0
1008460,19,NA,200000,200000,0
1008460,20,NA,200000,200000,0
1008460,21,NA,200000,200000,0
1008460,22,NA,200000,200000,0
1008460,23,NA,200000,200000,0
1008460,24,NA,200000,200000,0
1008478,1,32,357000,350000,-7000
1008478,2,19,350000,330000,-20000
1008478,3,47,330000,322000,-8000
1008478,4,75,322000,345000,23000
1008478,5,66,345000,380000,35000
1008478,6,24,380000,389000,9000
1008478,7,NA,389000,389000,0
1008478,8,15,389000,372000,-17000
1008478,9,56,372000,367000,-5000
1008478,10,60,367000,371000,4000
1008478,11,58,371000,385000,14000
1008478,12,34,385000,388000,3000
1008478,13,58,388000,400000,12000
1008478,14,NA,400000,400000,0
1008478,15,NA,400000,400000,0
1008478,16,NA,400000,400000,0
1008478,17,NA,400000,400000,0
1008478,18,NA,400000,400000,0
1008478,19,49,400000,406000,6000
1008478,20,62,406000,418000,12000
1008478,21,23,418000,406000,-12000
1008478,22,20,406000,379000,-27000
1008478,23,NA,379000,379000,0
1008478,24,3,379000,330000,-49000
1008510,1,NA,370000,370000,0
1008510,2,57,370000,380000,10000
1008510,3,60,380000,399000,19000
1008510,4,61,399000,422000,23000
1008510,5,38,422000,428000,6000
1008510,6,52,428000,432000,4000
1008510,7,44,432000,427000,-5000
1008510,8,48,427000,421000,-6000
1008510,9,44,421000,413000,-8000
1008510,10,52,413000,411000,-2000
1008510,11,37,411000,402000,-9000
1008510,12,NA,402000,402000,0
1008510,13,NA,402000,402000,0
1008510,14,NA,402000,402000,0
1008510,15,NA,402000,402000,0
1008510,16,NA,402000,402000,0
1008510,17,NA,402000,402000,0
1008510,18,NA,402000,402000,0
1008510,19,NA,402000,402000,0
1008510,20,NA,402000,402000,0
1008510,21,NA,402000,402000,0
1008510,22,NA,402000,402000,0
1008510,23,NA,402000,402000,0
1008510,24,51,402000,397000,-5000
1008537,1,NA,230000,230000,0
1008537,2,NA,230000,230000,0
1008537,3,NA,230000,230000,0
1008537,4,NA,230000,230000,0
1008537,5,NA,230000,230000,0
1008537,6,NA,230000,230000,0
1008537,7,NA,230000,230000,0
1008537,8,NA,230000,230000,0
1008537,9,NA,230000,230000,0
1008537,10,NA,230000,230000,0
1008537,11,NA,230000,230000,0
1008537,12,NA,230000,230000,0
1008537,13,NA,230000,230000,0
1008537,14,NA,230000,230000,0
1008537,15,NA,230000,230000,0
1008537,16,NA,230000,230000,0
1008537,17,NA,230000,230000,0
1008537,18,NA,230000,230000,0
1008537,19,NA,230000,230000,0
1008537,20,NA,230000,230000,0
1008537,21,NA,230000,230000,0
1008537,22,NA,230000,230000,0
1008537,23,NA,230000,230000,0
1008537,24,NA,230000,230000,0
1008541,1,120,497000,543000,46000
1008541,2,NA,543000,543000,0
1008541,3,NA,543000,543000,0
1008541,4,87,543000,592000,49000
1008541,5,61,592000,619000,27000
1008541,6,37,619000,608000,-11000
1008541,7,85,608000,606000,-2000
1008541,8,62,606000,592000,-14000
1008541,9,65,592000,581000,-11000
1008541,10,28,581000,547000,-34000
1008541,11,73,547000,534000,-13000
1008541,12,28,534000,500000,-34000
1008541,13,41,500000,467000,-33000
1008541,14,NA,467000,467000,0
1008541,15,69,467000,459000,-8000
1008541,16,80,459000,476000,17000
1008541,17,26,476000,465000,-11000
1008541,18,77,465000,477000,12000
1008541,19,93,477000,510000,33000
1008541,20,65,510000,531000,21000
1008541,21,62,531000,543000,12000
1008541,22,73,543000,558000,15000
1008541,23,27,558000,535000,-23000
1008541,24,66,535000,518000,-17000
1008543,1,70,551000,556000,5000
1008543,2,45,556000,545000,-11000
1008543,3,NA,545000,545000,0
1008543,4,21,545000,506000,-39000
1008543,5,NA,506000,506000,0
1008543,6,NA,506000,506000,0
1008543,7,20,506000,453000,-53000
1008543,8,NA,453000,453000,0
1008543,9,NA,453000,453000,0
1008543,10,NA,453000,453000,0
1008543,11,NA,453000,453000,0
1008543,12,NA,453000,453000,0
1008543,13,NA,453000,453000,0
1008543,14,NA,453000,453000,0
1008543,15,NA,453000,453000,0
1008543,16,NA,453000,453000,0
1008543,17,30,453000,403000,-50000
1008543,18,NA,403000,403000,0
1008543,19,84,403000,399000,-4000
1008543,20,66,399000,414000,15000
1008543,21,56,414000,434000,20000
1008543,22,82,434000,470000,36000
1008543,23,53,470000,489000,19000
1008543,24,31,489000,476000,-13000
1008550,1,98,537000,564000,27000
1008550,2,92,564000,603000,39000
1008550,3,128,603000,671000,68000
1008550,4,99,671000,727000,56000
1008550,5,NA,727000,727000,0
1008550,6,NA,727000,727000,0
1008550,7,100,727000,768000,41000
1008550,8,85,768000,786000,18000
1008550,9,77,786000,781000,-5000
1008550,10,86,781000,768000,-13000
1008550,11,101,768000,766000,-2000
1008550,12,70,766000,750000,-16000
1008550,13,98,750000,748000,-2000
1008550,14,NA,748000,748000,0
1008550,15,116,748000,769000,21000
1008550,16,79,769000,775000,6000
1008550,17,87,775000,774000,-1000
1008550,18,111,774000,788000,14000
1008550,19,80,788000,785000,-3000
1008550,20,119,785000,800000,15000
1008550,21,106,800000,818000,18000
1008550,22,96,818000,829000,11000
1008550,23,89,829000,827000,-2000
1008550,24,85,827000,813000,-14000
1008616,1,NA,200000,200000,0
1008616,2,NA,200000,200000,0
1008616,3,NA,200000,200000,0
1008616,4,NA,200000,200000,0
1008616,5,NA,200000,200000,0
1008616,6,NA,200000,200000,0
1008616,7,NA,200000,200000,0
1008616,8,NA,200000,200000,0
1008616,9,NA,200000,200000,0
1008616,10,NA,200000,200000,0
1008616,11,NA,200000,200000,0
1008616,12,NA,200000,200000,0
1008616,13,NA,200000,200000,0
1008616,14,NA,200000,200000,0
1008616,15,NA,200000,200000,0
1008616,16,NA,200000,200000,0
1008616,17,NA,200000,200000,0
1008616,18,NA,200000,200000,0
1008616,19,30,200000,204000,4000
1008616,20,13,204000,200000,-4000
1008616,21,52,200000,216000,16000
1008616,22,38,216000,235000,19000
1008616,23,NA,235000,235000,0
1008616,24,NA,235000,235000,0
1008691,1,NA,358000,358000,0
1008691,2,NA,358000,358000,0
1008691,3,NA,358000,358000,0
1008691,4,NA,358000,358000,0
1008691,5,NA,358000,358000,0
1008691,6,NA,358000,358000,0
1008691,7,NA,358000,358000,0
1008691,8,NA,358000,358000,0
1008691,9,NA,358000,358000,0
1008691,10,NA,358000,358000,0
1008691,11,NA,358000,358000,0
1008691,12,NA,358000,358000,0
1008691,13,NA,358000,358000,0
1008691,14,NA,358000,358000,0
1008691,15,NA,358000,358000,0
1008691,16,NA,358000,358000,0
1008691,17,NA,358000,358000,0
1008691,18,NA,358000,358000,0
1008691,19,NA,358000,358000,0
1008691,20,NA,358000,358000,0
1008691,21,NA,358000,358000,0
1008691,22,NA,358000,358000,0
1008691,23,NA,358000,358000,0
1008691,24,NA,358000,358000,0
1008752,1,NA,495000,495000,0
1008752,2,NA,495000,495000,0
1008752,3,NA,495000,495000,0
1008752,4,NA,495000,495000,0
1008752,5,NA,495000,495000,0
1008752,6,NA,495000,495000,0
1008752,7,NA,495000,495000,0
1008752,8,NA,495000,495000,0
1008752,9,NA,495000,495000,0
1008752,10,NA,495000,495000,0
1008752,11,NA,495000,495000,0
1008752,12,NA,495000,495000,0
1008752,13,NA,495000,495000,0
1008752,14,NA,495000,495000,0
1008752,15,NA,495000,495000,0
1008752,16,NA,495000,495000,0
1008752,17,NA,495000,495000,0
1008752,18,NA,495000,495000,0
1008752,19,NA,495000,495000,0
1008752,20,NA,495000,495000,0
1008752,21,NA,495000,495000,0
1008752,22,NA,495000,495000,0
1008752,23,NA,495000,495000,0
1008752,24,NA,495000,495000,0
1008825,1,NA,200000,200000,0
1008825,2,NA,200000,200000,0
1008825,3,NA,200000,200000,0
1008825,4,NA,200000,200000,0
1008825,5,NA,200000,200000,0
1008825,6,NA,200000,200000,0
1008825,7,NA,200000,200000,0
1008825,8,NA,200000,200000,0
1008825,9,NA,200000,200000,0
1008825,10,NA,200000,200000,0
1008825,11,NA,200000,200000,0
1008825,12,NA,200000,200000,0
1008825,13,NA,200000,200000,0
1008825,14,NA,200000,200000,0
1008825,15,NA,200000,200000,0
1008825,16,NA,200000,200000,0
1008825,17,NA,200000,200000,0
1008825,18,NA,200000,200000,0
1008825,19,NA,200000,200000,0
1008825,20,NA,200000,200000,0
1008825,21,NA,200000,200000,0
1008825,22,NA,200000,200000,0
1008825,23,NA,200000,200000,0
1008825,24,NA,200000,200000,0
1008855,1,55,452000,454000,2000
1008855,2,63,454000,464000,10000
1008855,3,88,464000,495000,31000
1008855,4,72,495000,524000,29000
1008855,5,38,524000,526000,2000
1008855,6,59,526000,524000,-2000
1008855,7,86,524000,537000,13000
1008855,8,58,537000,540000,3000
1008855,9,62,540000,540000,0
1008855,10,74,540000,550000,10000
1008855,11,60,550000,551000,1000
1008855,12,97,551000,572000,21000
1008855,13,14,572000,548000,-24000
1008855,14,47,548000,523000,-25000
1008855,15,NA,523000,523000,0
1008855,16,NA,523000,523000,0
1008855,17,NA,523000,523000,0
1008855,18,NA,523000,523000,0
1008855,19,52,523000,496000,-27000
1008855,20,NA,496000,496000,0
1008855,21,NA,496000,496000,0
1008855,22,30,496000,459000,-37000
1008855,23,64,459000,443000,-16000
1008855,24,65,443000,446000,3000
1008882,1,56,491000,491000,0
1008882,2,18,491000,462000,-29000
1008882,3,57,462000,445000,-17000
1008882,4,64,445000,443000,-2000
1008882,5,62,443000,451000,8000
1008882,6,72,451000,473000,22000
1008882,7,115,473000,531000,58000
1008882,8,78,531000,577000,46000
1008882,9,77,577000,610000,33000
1008882,10,75,610000,630000,20000
1008882,11,56,630000,625000,-5000
1008882,12,47,625000,597000,-28000
1008882,13,NA,597000,597000,0
1008882,14,63,597000,577000,-20000
1008882,15,55,577000,554000,-23000
1008882,16,79,554000,551000,-3000
1008882,17,51,551000,542000,-9000
1008882,18,31,542000,514000,-28000
1008882,19,57,514000,495000,-19000
1008882,20,56,495000,481000,-14000
1008882,21,58,481000,473000,-8000
1008882,22,33,473000,454000,-19000
1008882,23,26,454000,425000,-29000
1008882,24,32,425000,392000,-33000
1008893,1,59,367000,379000,12000
1008893,2,23,379000,373000,-6000
1008893,3,59,373000,380000,7000
1008893,4,56,380000,392000,12000
1008893,5,67,392000,415000,23000
1008893,6,43,415000,425000,10000
1008893,7,NA,425000,425000,0
1008893,8,53,425000,434000,9000
1008893,9,51,434000,437000,3000
1008893,10,NA,437000,437000,0
1008893,11,NA,437000,437000,0
1008893,12,NA,437000,437000,0
1008893,13,NA,437000,437000,0
1008893,14,NA,437000,437000,0
1008893,15,22,437000,417000,-20000
1008893,16,69,417000,417000,0
1008893,17,62,417000,427000,10000
1008893,18,11,427000,405000,-22000
1008893,19,NA,405000,405000,0
1008893,20,117,405000,441000,36000
1008893,21,33,441000,452000,11000
1008893,22,NA,452000,452000,0
1008893,23,NA,452000,452000,0
1008893,24,NA,452000,452000,0
1008975,1,NA,254000,254000,0
1008975,2,NA,254000,254000,0
1008975,3,NA,254000,254000,0
1008975,4,NA,254000,254000,0
1008975,5,NA,254000,254000,0
1008975,6,NA,254000,254000,0
1008975,7,NA,254000,254000,0
1008975,8,NA,254000,254000,0
1008975,9,64,254000,278000,24000
1008975,10,64,278000,317000,39000
1008975,11,NA,317000,317000,0
1008975,12,NA,317000,317000,0
1008975,13,NA,317000,317000,0
1008975,14,NA,317000,317000,0
1008975,15,NA,317000,317000,0
1008975,16,NA,317000,317000,0
1008975,17,NA,317000,317000,0
1008975,18,NA,317000,317000,0
1008975,19,NA,317000,317000,0
1008975,20,NA,317000,317000,0
1008975,21,NA,317000,317000,0
1008975,22,40,317000,345000,28000
1008975,23,NA,345000,345000,0
1008975,24,0,345000,330000,-15000
1009015,1,NA,417000,417000,0
1009015,2,NA,417000,417000,0
1009015,3,NA,417000,417000,0
1009015,4,NA,417000,417000,0
1009015,5,NA,417000,417000,0
1009015,6,21,417000,397000,-20000
1009015,7,53,397000,386000,-11000
1009015,8,6,386000,352000,-34000
1009015,9,8,352000,307000,-45000
1009015,10,22,307000,270000,-37000
1009015,11,32,270000,250000,-20000
1009015,12,18,250000,230000,-20000
1009015,13,NA,230000,230000,0
1009015,14,39,230000,232000,2000
1009015,15,NA,232000,232000,0
1009015,16,42,232000,246000,14000
1009015,17,50,246000,270000,24000
1009015,18,43,270000,292000,22000
1009015,19,NA,292000,292000,0
1009015,20,NA,292000,292000,0
1009015,21,NA,292000,292000,0
1009015,22,NA,292000,292000,0
1009015,23,16,292000,293000,1000
1009015,24,7,293000,270000,-23000
1009029,1,NA,200000,200000,0
1009029,2,NA,200000,200000,0
1009029,3,NA,200000,200000,0
1009029,4,NA,200000,200000,0
1009029,5,NA,200000,200000,0
1009029,6,NA,200000,200000,0
1009029,7,NA,200000,200000,0
1009029,8,NA,200000,200000,0
1009029,9,NA,200000,200000,0
1009029,10,NA,200000,200000,0
1009029,11,NA,200000,200000,0
1009029,12,NA,200000,200000,0
1009029,13,NA,200000,200000,0
1009029,14,NA,200000,200000,0
1009029,15,NA,200000,200000,0
1009029,16,NA,200000,200000,0
1009029,17,NA,200000,200000,0
1009029,18,NA,200000,200000,0
1009029,19,NA,200000,200000,0
1009029,20,NA,200000,200000,0
1009029,21,90,200000,246000,46000
1009029,22,8,246000,266000,20000
1009029,23,29,266000,275000,9000
1009029,24,29,275000,275000,0
1009186,1,NA,509000,509000,0
1009186,2,NA,509000,509000,0
1009186,3,NA,509000,509000,0
1009186,4,NA,509000,509000,0
1009186,5,NA,509000,509000,0
1009186,6,NA,509000,509000,0
1009186,7,NA,509000,509000,0
1009186,8,NA,509000,509000,0
1009186,9,NA,509000,509000,0
1009186,10,NA,509000,509000,0
1009186,11,NA,509000,509000,0
1009186,12,NA,509000,509000,0
1009186,13,NA,509000,509000,0
1009186,14,NA,509000,509000,0
1009186,15,NA,509000,509000,0
1009186,16,NA,509000,509000,0
1009186,17,34,509000,490000,-19000
1009186,18,NA,490000,490000,0
1009186,19,NA,490000,490000,0
1009186,20,NA,490000,490000,0
1009186,21,NA,490000,490000,0
1009186,22,NA,490000,490000,0
1009186,23,NA,490000,490000,0
1009186,24,NA,490000,490000,0
1009189,1,NA,384000,384000,0
1009189,2,NA,384000,384000,0
1009189,3,NA,384000,384000,0
1009189,4,NA,384000,384000,0
1009189,5,NA,384000,384000,0
1009189,6,NA,384000,384000,0
1009189,7,NA,384000,384000,0
1009189,8,63,384000,396000,12000
1009189,9,32,396000,395000,-1000
1009189,10,NA,395000,395000,0
1009189,11,NA,395000,395000,0
1009189,12,NA,395000,395000,0
1009189,13,NA,395000,395000,0
1009189,14,NA,395000,395000,0
1009189,15,NA,395000,395000,0
1009189,16,NA,395000,395000,0
1009189,17,NA,395000,395000,0
1009189,18,NA,395000,395000,0
1009189,19,NA,395000,395000,0
1009189,20,NA,395000,395000,0
1009189,21,NA,395000,395000,0
1009189,22,NA,395000,395000,0
1009189,23,NA,395000,395000,0
1009189,24,NA,395000,395000,0
1009191,1,89,615000,628000,13000
1009191,2,62,628000,630000,2000
1009191,3,86,630000,641000,11000
1009191,4,57,641000,633000,-8000
1009191,5,56,633000,615000,-18000
1009191,6,53,615000,590000,-25000
1009191,7,77,590000,580000,-10000
1009191,8,72,580000,576000,-4000
1009191,9,106,576000,604000,28000
1009191,10,44,604000,604000,0
1009191,11,52,604000,590000,-14000
1009191,12,78,590000,585000,-5000
1009191,13,46,585000,563000,-22000
1009191,14,22,563000,520000,-43000
1009191,15,NA,520000,520000,0
1009191,16,30,520000,473000,-47000
1009191,17,48,473000,439000,-34000
1009191,18,40,439000,410000,-29000
1009191,19,58,410000,402000,-8000
1009191,20,53,402000,406000,4000
1009191,21,NA,406000,406000,0
1009191,22,74,406000,429000,23000
1009191,23,58,429000,448000,19000
1009191,24,59,448000,462000,14000
1009195,1,NA,200000,200000,0
1009195,2,NA,200000,200000,0
1009195,3,NA,200000,200000,0
1009195,4,49,200000,218000,18000
1009195,5,46,218000,246000,28000
1009195,6,32,246000,268000,22000
1009195,7,67,268000,305000,37000
1009195,8,92,305000,367000,62000
1009195,9,62,367000,416000,49000
1009195,10,82,416000,468000,52000
1009195,11,56,468000,498000,30000
1009195,12,78,498000,525000,27000
1009195,13,65,525000,538000,13000
1009195,14,76,538000,557000,19000
1009195,15,NA,557000,557000,0
1009195,16,75,557000,572000,15000
1009195,17,58,572000,574000,2000
1009195,18,60,574000,568000,-6000
1009195,19,11,568000,523000,-45000
1009195,20,27,523000,470000,-53000
1009195,21,79,470000,452000,-18000
1009195,22,61,452000,449000,-3000
1009195,23,88,449000,475000,26000
1009195,24,35,475000,480000,5000
1009197,1,NA,200000,200000,0
1009197,2,NA,200000,200000,0
1009197,3,NA,200000,200000,0
1009197,4,NA,200000,200000,0
1009197,5,NA,200000,200000,0
1009197,6,NA,200000,200000,0
1009197,7,NA,200000,200000,0
1009197,8,NA,200000,200000,0
1009197,9,NA,200000,200000,0
1009197,10,NA,200000,200000,0
1009197,11,NA,200000,200000,0
1009197,12,NA,200000,200000,0
1009197,13,NA,200000,200000,0
1009197,14,NA,200000,200000,0
1009197,15,NA,200000,200000,0
1009197,16,NA,200000,200000,0
1009197,17,NA,200000,200000,0
1009197,18,NA,200000,200000,0
1009197,19,NA,200000,200000,0
1009197,20,NA,200000,200000,0
1009197,21,NA,200000,200000,0
1009197,22,NA,200000,200000,0
1009197,23,NA,200000,200000,0
1009197,24,NA,200000,200000,0
1009199,1,78,870000,854000,-16000
1009199,2,83,854000,830000,-24000
1009199,3,72,830000,797000,-33000
1009199,4,159,797000,825000,28000
1009199,5,107,825000,853000,28000
1009199,6,102,853000,876000,23000
1009199,7,134,876000,912000,36000
1009199,8,132,912000,951000,39000
1009199,9,86,951000,951000,0
1009199,10,79,951000,925000,-26000
1009199,11,90,925000,894000,-31000
1009199,12,109,894000,873000,-21000
1009199,13,NA,873000,873000,0
1009199,14,100,873000,863000,-10000
1009199,15,107,863000,864000,1000
1009199,16,123,864000,882000,18000
1009199,17,104,882000,894000,12000
1009199,18,85,894000,885000,-9000
1009199,19,89,885000,867000,-18000
1009199,20,110,867000,860000,-7000
1009199,21,84,860000,842000,-18000
1009199,22,94,842000,828000,-14000
1009199,23,84,828000,811000,-17000
1009199,24,101,811000,801000,-10000
1009201,1,NA,200000,200000,0
1009201,2,NA,200000,200000,0
1009201,3,NA,200000,200000,0
1009201,4,NA,200000,200000,0
1009201,5,NA,200000,200000,0
1009201,6,NA,200000,200000,0
1009201,7,NA,200000,200000,0
1009201,8,NA,200000,200000,0
1009201,9,NA,200000,200000,0
1009201,10,NA,200000,200000,0
1009201,11,NA,200000,200000,0
1009201,12,NA,200000,200000,0
1009201,13,NA,200000,200000,0
1009201,14,NA,200000,200000,0
1009201,15,NA,200000,200000,0
1009201,16,NA,200000,200000,0
1009201,17,NA,200000,200000,0
1009201,18,NA,200000,200000,0
1009201,19,NA,200000,200000,0
1009201,20,NA,200000,200000,0
1009201,21,NA,200000,200000,0
1009201,22,NA,200000,200000,0
1009201,23,NA,200000,200000,0
1009201,24,NA,200000,200000,0
1009208,1,109,664000,688000,24000
1009208,2,95,688000,717000,29000
1009208,3,78,717000,732000,15000
1009208,4,60,732000,720000,-12000
1009208,5,100,720000,723000,3000
1009208,6,98,723000,732000,9000
1009208,7,110,732000,755000,23000
1009208,8,76,755000,762000,7000
1009208,9,142,762000,804000,42000
1009208,10,90,804000,824000,20000
1009208,11,124,824000,853000,29000
1009208,12,73,853000,849000,-4000
1009208,13,NA,849000,849000,0
1009208,14,80,849000,836000,-13000
1009208,15,68,836000,800000,-36000
1009208,16,95,800000,779000,-21000
1009208,17,86,779000,760000,-19000
1009208,18,89,760000,752000,-8000
1009208,19,69,752000,735000,-17000
1009208,20,104,735000,738000,3000
1009208,21,73,738000,730000,-8000
1009208,22,89,730000,726000,-4000
1009208,23,88,726000,726000,0
1009208,24,120,726000,747000,21000
1009226,1,NA,366000,366000,0
1009226,2,NA,366000,366000,0
1009226,3,NA,366000,366000,0
1009226,4,NA,366000,366000,0
1009226,5,NA,366000,366000,0
1009226,6,NA,366000,366000,0
1009226,7,NA,366000,366000,0
1009226,8,NA,366000,366000,0
1009226,9,NA,366000,366000,0
1009226,10,22,366000,350000,-16000
1009226,11,NA,350000,350000,0
1009226,12,NA,350000,350000,0
1009226,13,NA,350000,350000,0
1009226,14,NA,350000,350000,0
1009226,15,NA,350000,350000,0
1009226,16,NA,350000,350000,0
1009226,17,NA,350000,350000,0
1009226,18,NA,350000,350000,0
1009226,19,NA,350000,350000,0
1009226,20,NA,350000,350000,0
1009226,21,NA,350000,350000,0
1009226,22,73,350000,361000,11000
1009226,23,59,361000,380000,19000
1009226,24,66,380000,406000,26000
1009228,1,NA,270000,270000,0
1009228,2,NA,270000,270000,0
1009228,3,NA,270000,270000,0
1009228,4,NA,270000,270000,0
1009228,5,NA,270000,270000,0
1009228,6,NA,270000,270000,0
1009228,7,NA,270000,270000,0
1009228,8,NA,270000,270000,0
1009228,9,NA,270000,270000,0
1009228,10,NA,270000,270000,0
1009228,11,NA,270000,270000,0
1009228,12,NA,270000,270000,0
1009228,13,NA,270000,270000,0
1009228,14,NA,270000,270000,0
1009228,15,NA,270000,270000,0
1009228,16,NA,270000,270000,0
1009228,17,NA,270000,270000,0
1009228,18,NA,270000,270000,0
1009228,19,NA,270000,270000,0
1009228,20,NA,270000,270000,0
1009228,21,NA,270000,270000,0
1009228,22,NA,270000,270000,0
1009228,23,NA,270000,270000,0
1009228,24,NA,270000,270000,0
1009229,1,16,421000,397000,-24000
1009229,2,39,397000,375000,-22000
1009229,3,35,375000,354000,-21000
1009229,4,NA,354000,354000,0
1009229,5,46,354000,346000,-8000
1009229,6,52,346000,352000,6000
1009229,7,59,352000,371000,19000
1009229,8,NA,371000,371000,0
1009229,9,NA,371000,371000,0
1009229,10,NA,371000,371000,0
1009229,11,41,371000,380000,9000
1009229,12,36,380000,379000,-1000
1009229,13,NA,379000,379000,0
1009229,14,34,379000,372000,-7000
1009229,15,59,372000,375000,3000
1009229,16,52,375000,383000,8000
1009229,17,47,383000,389000,6000
1009229,18,30,389000,383000,-6000
1009229,19,59,383000,388000,5000
1009229,20,75,388000,410000,22000
1009229,21,64,410000,435000,25000
1009229,22,48,435000,448000,13000
1009229,23,57,448000,459000,11000
1009229,24,62,459000,466000,7000
1009241,1,NA,392000,392000,0
1009241,2,NA,392000,392000,0
1009241,3,NA,392000,392000,0
1009241,4,NA,392000,392000,0
1009241,5,NA,392000,392000,0
1009241,6,NA,392000,392000,0
1009241,7,107,392000,435000,43000
1009241,8,46,435000,463000,28000
1009241,9,NA,463000,463000,0
1009241,10,NA,463000,463000,0
1009241,11,79,463000,497000,34000
1009241,12,73,497000,526000,29000
1009241,13,52,526000,533000,7000
1009241,14,87,533000,553000,20000
1009241,15,NA,553000,553000,0
1009241,16,86,553000,580000,27000
1009241,17,29,580000,565000,-15000
1009241,18,49,565000,543000,-22000
1009241,19,97,543000,552000,9000
1009241,20,63,552000,553000,1000
1009241,21,77,553000,564000,11000
1009241,22,84,564000,585000,21000
1009241,23,62,585000,593000,8000
1009241,24,61,593000,586000,-7000
1009253,1,55,576000,568000,-8000
1009253,2,70,568000,565000,-3000
1009253,3,99,565000,588000,23000
1009253,4,89,588000,617000,29000
1009253,5,83,617000,644000,27000
1009253,6,62,644000,652000,8000
1009253,7,89,652000,663000,11000
1009253,8,102,663000,684000,21000
1009253,9,123,684000,726000,42000
1009253,10,64,726000,736000,10000
1009253,11,95,736000,748000,12000
1009253,12,97,748000,758000,10000
1009253,13,83,758000,757000,-1000
1009253,14,83,757000,753000,-4000
1009253,15,NA,753000,753000,0
1009253,16,78,753000,744000,-9000
1009253,17,74,744000,726000,-18000
1009253,18,73,726000,706000,-20000
1009253,19,87,706000,696000,-10000
1009253,20,97,696000,702000,6000
1009253,21,97,702000,717000,15000
1009253,22,76,717000,721000,4000
1009253,23,89,721000,726000,5000
1009253,24,75,726000,716000,-10000
1009256,1,118,776000,797000,21000
1009256,2,52,797000,783000,-14000
1009256,3,80,783000,765000,-18000
1009256,4,78,765000,744000,-21000
1009256,5,83,744000,728000,-16000
1009256,6,77,728000,713000,-15000
1009256,7,112,713000,728000,15000
1009256,8,102,728000,750000,22000
1009256,9,108,750000,779000,29000
1009256,10,83,779000,789000,10000
1009256,11,98,789000,798000,9000
1009256,12,NA,798000,798000,0
1009256,13,79,798000,788000,-10000
1009256,14,79,788000,775000,-13000
1009256,15,61,775000,743000,-32000
1009256,16,83,743000,721000,-22000
1009256,17,108,721000,723000,2000
1009256,18,NA,723000,723000,0
1009256,19,73,723000,718000,-5000
1009256,20,83,718000,715000,-3000
1009256,21,119,715000,740000,25000
1009256,22,102,740000,764000,24000
1009256,23,91,764000,777000,13000
1009256,24,94,777000,784000,7000
1009260,1,69,508000,516000,8000
1009260,2,53,516000,517000,1000
1009260,3,26,517000,492000,-25000
1009260,4,NA,492000,492000,0
1009260,5,NA,492000,492000,0
1009260,6,NA,492000,492000,0
1009260,7,NA,492000,492000,0
1009260,8,56,492000,474000,-18000
1009260,9,NA,474000,474000,0
1009260,10,NA,474000,474000,0
1009260,11,NA,474000,474000,0
1009260,12,NA,474000,474000,0
1009260,13,NA,474000,474000,0
1009260,14,NA,474000,474000,0
1009260,15,94,474000,490000,16000
1009260,16,101,490000,531000,41000
1009260,17,67,531000,562000,31000
1009260,18,120,562000,621000,59000
1009260,19,110,621000,681000,60000
1009260,20,103,681000,729000,48000
1009260,21,94,729000,760000,31000
1009260,22,90,760000,777000,17000
1009260,23,125,777000,805000,28000
1009260,24,146,805000,851000,46000
1009288,1,NA,200000,200000,0
1009288,2,NA,200000,200000,0
1009288,3,NA,200000,200000,0
1009288,4,NA,200000,200000,0
1009288,5,NA,200000,200000,0
1009288,6,NA,200000,200000,0
1009288,7,NA,200000,200000,0
1009288,8,NA,200000,200000,0
1009288,9,NA,200000,200000,0
1009288,10,NA,200000,200000,0
1009288,11,NA,200000,200000,0
1009288,12,NA,200000,200000,0
1009288,13,NA,200000,200000,0
1009288,14,NA,200000,200000,0
1009288,15,NA,200000,200000,0
1009288,16,NA,200000,200000,0
1009288,17,NA,200000,200000,0
1009288,18,NA,200000,200000,0
1009288,19,NA,200000,200000,0
1009288,20,NA,200000,200000,0
1009288,21,NA,200000,200000,0
1009288,22,NA,200000,200000,0
1009288,23,NA,200000,200000,0
1009288,24,NA,200000,200000,0
1009291,1,NA,309000,309000,0
1009291,2,NA,309000,309000,0
1009291,3,NA,309000,309000,0
1009291,4,NA,309000,309000,0
1009291,5,NA,309000,309000,0
1009291,6,NA,309000,309000,0
1009291,7,NA,309000,309000,0
1009291,8,NA,309000,309000,0
1009291,9,NA,309000,309000,0
1009291,10,NA,309000,309000,0
1009291,11,NA,309000,309000,0
1009291,12,NA,309000,309000,0
1009291,13,NA,309000,309000,0
1009291,14,NA,309000,309000,0
1009291,15,NA,309000,309000,0
1009291,16,NA,309000,309000,0
1009291,17,NA,309000,309000,0
1009291,18,NA,309000,309000,0
1009291,19,NA,309000,309000,0
1009291,20,NA,309000,309000,0
1009291,21,NA,309000,309000,0
1009291,22,NA,309000,309000,0
1009291,23,NA,309000,309000,0
1009291,24,NA,309000,309000,0
1009301,1,42,420000,415000,-5000
1009301,2,26,415000,396000,-19000
1009301,3,67,396000,398000,2000
1009301,4,53,398000,405000,7000
1009301,5,41,405000,406000,1000
1009301,6,76,406000,428000,22000
1009301,7,47,428000,440000,12000
1009301,8,41,440000,438000,-2000
1009301,9,48,438000,433000,-5000
1009301,10,48,433000,427000,-6000
1009301,11,87,427000,447000,20000
1009301,12,66,447000,470000,23000
1009301,13,66,470000,493000,23000
1009301,14,67,493000,516000,23000
1009301,15,NA,516000,516000,0
1009301,16,94,516000,551000,35000
1009301,17,92,551000,588000,37000
1009301,18,48,588000,594000,6000
1009301,19,84,594000,606000,12000
1009301,20,38,606000,588000,-18000
1009301,21,97,588000,593000,5000
1009301,22,68,593000,593000,0
1009301,23,36,593000,571000,-22000
1009301,24,49,571000,542000,-29000
1009308,1,NA,508000,508000,0
1009308,2,NA,508000,508000,0
1009308,3,23,508000,481000,-27000
1009308,4,102,481000,494000,13000
1009308,5,65,494000,510000,16000
1009308,6,55,510000,518000,8000
1009308,7,28,518000,500000,-18000
1009308,8,-2,500000,446000,-54000
1009308,9,NA,446000,446000,0
1009308,10,NA,446000,446000,0
1009308,11,NA,446000,446000,0
1009308,12,9,446000,375000,-71000
1009308,13,NA,375000,375000,0
1009308,14,NA,375000,375000,0
1009308,15,NA,375000,375000,0
1009308,16,37,375000,328000,-47000
1009308,17,NA,328000,328000,0
1009308,18,NA,328000,328000,0
1009308,19,NA,328000,328000,0
1009308,20,NA,328000,328000,0
1009308,21,72,328000,324000,-4000
1009308,22,NA,324000,324000,0
1009308,23,NA,324000,324000,0
1009308,24,NA,324000,324000,0
1009320,1,NA,280000,280000,0
1009320,2,NA,280000,280000,0
1009320,3,35,280000,281000,1000
1009320,4,42,281000,289000,8000
1009320,5,NA,289000,289000,0
1009320,6,NA,289000,289000,0
1009320,7,NA,289000,289000,0
1009320,8,NA,289000,289000,0
1009320,9,56,289000,309000,20000
1009320,10,NA,309000,309000,0
1009320,11,NA,309000,309000,0
1009320,12,NA,309000,309000,0
1009320,13,NA,309000,309000,0
1009320,14,NA,309000,309000,0
1009320,15,47,309000,330000,21000
1009320,16,21,330000,330000,0
1009320,17,49,330000,336000,6000
1009320,18,41,336000,338000,2000
1009320,19,17,338000,322000,-16000
1009320,20,NA,322000,322000,0
1009320,21,NA,322000,322000,0
1009320,22,NA,322000,322000,0
1009320,23,NA,322000,322000,0
1009320,24,NA,322000,322000,0
1009378,1,94,456000,487000,31000
1009378,2,65,487000,515000,28000
1009378,3,78,515000,547000,32000
1009378,4,104,547000,594000,47000
1009378,5,78,594000,627000,33000
1009378,6,51,627000,628000,1000
1009378,7,78,628000,630000,2000
1009378,8,72,630000,627000,-3000
1009378,9,94,627000,637000,10000
1009378,10,77,637000,644000,7000
1009378,11,46,644000,630000,-14000
1009378,12,85,630000,627000,-3000
1009378,13,75,627000,625000,-2000
1009378,14,NA,625000,625000,0
1009378,15,95,625000,639000,14000
1009378,16,67,639000,643000,4000
1009378,17,79,643000,649000,6000
1009378,18,61,649000,640000,-9000
1009378,19,71,640000,630000,-10000
1009378,20,73,630000,621000,-9000
1009378,21,72,621000,616000,-5000
1009378,22,77,616000,615000,-1000
1009378,23,108,615000,641000,26000
1009378,24,59,641000,643000,2000
1009380,1,NA,398000,398000,0
1009380,2,NA,398000,398000,0
1009380,3,NA,398000,398000,0
1009380,4,NA,398000,398000,0
1009380,5,NA,398000,398000,0
1009380,6,NA,398000,398000,0
1009380,7,NA,398000,398000,0
1009380,8,NA,398000,398000,0
1009380,9,NA,398000,398000,0
1009380,10,NA,398000,398000,0
1009380,11,NA,398000,398000,0
1009380,12,NA,398000,398000,0
1009380,13,NA,398000,398000,0
1009380,14,NA,398000,398000,0
1009380,15,NA,398000,398000,0
1009380,16,NA,398000,398000,0
1009380,17,NA,398000,398000,0
1009380,18,NA,398000,398000,0
1009380,19,NA,398000,398000,0
1009380,20,NA,398000,398000,0
1009380,21,NA,398000,398000,0
1009380,22,NA,398000,398000,0
1009380,23,NA,398000,398000,0
1009380,24,NA,398000,398000,0
1009383,1,NA,331000,331000,0
1009383,2,NA,331000,331000,0
1009383,3,NA,331000,331000,0
1009383,4,NA,331000,331000,0
1009383,5,NA,331000,331000,0
1009383,6,58,331000,345000,14000
1009383,7,NA,345000,345000,0
1009383,8,NA,345000,345000,0
1009383,9,NA,345000,345000,0
1009383,10,NA,345000,345000,0
1009383,11,NA,345000,345000,0
1009383,12,NA,345000,345000,0
1009383,13,NA,345000,345000,0
1009383,14,NA,345000,345000,0
1009383,15,NA,345000,345000,0
1009383,16,NA,345000,345000,0
1009383,17,NA,345000,345000,0
1009383,18,NA,345000,345000,0
1009383,19,NA,345000,345000,0
1009383,20,NA,345000,345000,0
1009383,21,NA,345000,345000,0
1009383,22,NA,345000,345000,0
1009383,23,NA,345000,345000,0
1009383,24,NA,345000,345000,0
1009385,1,31,449000,434000,-15000
1009385,2,4,434000,389000,-45000
1009385,3,NA,389000,389000,0
1009385,4,3,389000,327000,-62000
1009385,5,NA,327000,327000,0
1009385,6,NA,327000,327000,0
1009385,7,NA,327000,327000,0
1009385,8,NA,327000,327000,0
1009385,9,NA,327000,327000,0
1009385,10,NA,327000,327000,0
1009385,11,NA,327000,327000,0
1009385,12,NA,327000,327000,0
1009385,13,67,327000,310000,-17000
1009385,14,58,310000,319000,9000
1009385,15,33,319000,326000,7000
1009385,16,61,326000,351000,25000
1009385,17,55,351000,376000,25000
1009385,18,20,376000,370000,-6000
1009385,19,NA,370000,370000,0
1009385,20,NA,370000,370000,0
1009385,21,14,370000,344000,-26000
1009385,22,46,344000,330000,-14000
1009385,23,61,330000,335000,5000
1009385,24,49,335000,345000,10000
1009386,1,6,487000,450000,-37000
1009386,2,NA,450000,450000,0
1009386,3,NA,450000,450000,0
1009386,4,62,450000,429000,-21000
1009386,5,NA,429000,429000,0
1009386,6,NA,429000,429000,0
1009386,7,NA,429000,429000,0
1009386,8,NA,429000,429000,0
1009386,9,NA,429000,429000,0
1009386,10,NA,429000,429000,0
1009386,11,NA,429000,429000,0
1009386,12,NA,429000,429000,0
1009386,13,39,429000,407000,-22000
1009386,14,NA,407000,407000,0
1009386,15,NA,407000,407000,0
1009386,16,NA,407000,407000,0
1009386,17,NA,407000,407000,0
1009386,18,NA,407000,407000,0
1009386,19,NA,407000,407000,0
1009386,20,NA,407000,407000,0
1009386,21,41,407000,391000,-16000
1009386,22,67,391000,398000,7000
1009386,23,NA,398000,398000,0
1009386,24,NA,398000,398000,0
1009389,1,NA,200000,200000,0
1009389,2,NA,200000,200000,0
1009389,3,NA,200000,200000,0
1009389,4,NA,200000,200000,0
1009389,5,NA,200000,200000,0
1009389,6,NA,200000,200000,0
1009389,7,NA,200000,200000,0
1009389,8,NA,200000,200000,0
1009389,9,NA,200000,200000,0
1009389,10,NA,200000,200000,0
1009389,11,NA,200000,200000,0
1009389,12,NA,200000,200000,0
1009389,13,NA,200000,200000,0
1009389,14,NA,200000,200000,0
1009389,15,NA,200000,200000,0
1009389,16,NA,200000,200000,0
1009389,17,NA,200000,200000,0
1009389,18,NA,200000,200000,0
1009389,19,NA,200000,200000,0
1009389,20,NA,200000,200000,0
1009389,21,NA,200000,200000,0
1009389,22,NA,200000,200000,0
1009389,23,NA,200000,200000,0
1009389,24,NA,200000,200000,0
1009392,1,NA,200000,200000,0
1009392,2,NA,200000,200000,0
1009392,3,NA,200000,200000,0
1009392,4,NA,200000,200000,0
1009392,5,NA,200000,200000,0
1009392,6,NA,200000,200000,0
1009392,7,NA,200000,200000,0
1009392,8,NA,200000,200000,0
1009392,9,NA,200000,200000,0
1009392,10,NA,200000,200000,0
1009392,11,NA,200000,200000,0
1009392,12,NA,200000,200000,0
1009392,13,NA,200000,200000,0
1009392,14,19,200000,200000,0
1009392,15,NA,200000,200000,0
1009392,16,NA,200000,200000,0
1009392,17,NA,200000,200000,0
1009392,18,NA,200000,200000,0
1009392,19,NA,200000,200000,0
1009392,20,NA,200000,200000,0
1009392,21,NA,200000,200000,0
1009392,22,NA,200000,200000,0
1009392,23,NA,200000,200000,0
1009392,24,NA,200000,200000,0
1009399,1,59,631000,621000,-10000
1009399,2,58,621000,604000,-17000
1009399,3,95,604000,610000,6000
1009399,4,74,610000,617000,7000
1009399,5,76,617000,626000,9000
1009399,6,52,626000,618000,-8000
1009399,7,59,618000,602000,-16000
1009399,8,117,602000,623000,21000
1009399,9,103,623000,658000,35000
1009399,10,66,658000,671000,13000
1009399,11,108,671000,702000,31000
1009399,12,NA,702000,702000,0
1009399,13,119,702000,744000,42000
1009399,14,94,744000,774000,30000
1009399,15,89,774000,788000,14000
1009399,16,35,788000,756000,-32000
1009399,17,74,756000,720000,-36000
1009399,18,88,720000,696000,-24000
1009399,19,88,696000,687000,-9000
1009399,20,79,687000,683000,-4000
1009399,21,149,683000,734000,51000
1009399,22,103,734000,777000,43000
1009399,23,83,777000,795000,18000
1009399,24,80,795000,792000,-3000
1009410,1,NA,480000,480000,0
1009410,2,NA,480000,480000,0
1009410,3,NA,480000,480000,0
1009410,4,32,480000,461000,-19000
1009410,5,50,461000,445000,-16000
1009410,6,26,445000,417000,-28000
1009410,7,46,417000,397000,-20000
1009410,8,60,397000,397000,0
1009410,9,33,397000,389000,-8000
1009410,10,30,389000,373000,-16000
1009410,11,30,373000,355000,-18000
1009410,12,NA,355000,355000,0
1009410,13,32,355000,336000,-19000
1009410,14,70,336000,347000,11000
1009410,15,56,347000,366000,19000
1009410,16,60,366000,392000,26000
1009410,17,12,392000,384000,-8000
1009410,18,4,384000,349000,-35000
1009410,19,NA,349000,349000,0
1009410,20,NA,349000,349000,0
1009410,21,NA,349000,349000,0
1009410,22,NA,349000,349000,0
1009410,23,NA,349000,349000,0
1009410,24,NA,349000,349000,0
1009420,1,83,777000,772000,-5000
1009420,2,115,772000,788000,16000
1009420,3,127,788000,824000,36000
1009420,4,106,824000,854000,30000
1009420,5,125,854000,891000,37000
1009420,6,114,891000,921000,30000
1009420,7,94,921000,924000,3000
1009420,8,97,924000,915000,-9000
1009420,9,113,915000,912000,-3000
1009420,10,125,912000,919000,7000
1009420,11,104,919000,922000,3000
1009420,12,NA,922000,922000,0
1009420,13,113,922000,927000,5000
1009420,14,106,927000,933000,6000
1009420,15,102,933000,928000,-5000
1009420,16,134,928000,941000,13000
1009420,17,100,941000,941000,0
1009420,18,NA,941000,941000,0
1009420,19,102,941000,934000,-7000
1009420,20,101,934000,923000,-11000
1009420,21,125,923000,927000,4000
1009420,22,86,927000,911000,-16000
1009420,23,86,911000,886000,-25000
1009420,24,120,886000,879000,-7000
1009421,1,49,480000,475000,-5000
1009421,2,36,475000,458000,-17000
1009421,3,44,458000,440000,-18000
1009421,4,54,440000,430000,-10000
1009421,5,NA,430000,430000,0
1009421,6,NA,430000,430000,0
1009421,7,NA,430000,430000,0
1009421,8,NA,430000,430000,0
1009421,9,NA,430000,430000,0
1009421,10,NA,430000,430000,0
1009421,11,NA,430000,430000,0
1009421,12,NA,430000,430000,0
1009421,13,NA,430000,430000,0
1009421,14,NA,430000,430000,0
1009421,15,NA,430000,430000,0
1009421,16,22,430000,405000,-25000
1009421,17,59,405000,398000,-7000
1009421,18,62,398000,406000,8000
1009421,19,40,406000,406000,0
1009421,20,41,406000,402000,-4000
1009421,21,32,402000,390000,-12000
1009421,22,52,390000,384000,-6000
1009421,23,47,384000,380000,-4000
1009421,24,21,380000,361000,-19000
1009528,1,128,752000,782000,30000
1009528,2,90,782000,805000,23000
1009528,3,110,805000,831000,26000
1009528,4,111,831000,855000,24000
1009528,5,100,855000,868000,13000
1009528,6,NA,868000,868000,0
1009528,7,136,868000,897000,29000
1009528,8,170,897000,962000,65000
1009528,9,81,962000,977000,15000
1009528,10,111,977000,981000,4000
1009528,11,108,981000,976000,-5000
1009528,12,115,976000,967000,-9000
1009528,13,73,967000,928000,-39000
1009528,14,104,928000,910000,-18000
1009528,15,NA,910000,910000,0
1009528,16,108,910000,897000,-13000
1009528,17,69,897000,863000,-34000
1009528,18,NA,863000,863000,0
1009528,19,NA,863000,863000,0
1009528,20,NA,863000,863000,0
1009528,21,141,863000,871000,8000
1009528,22,118,871000,889000,18000
1009528,23,120,889000,910000,21000
1009528,24,109,910000,922000,12000
1009551,1,57,362000,373000,11000
1009551,2,23,373000,367000,-6000
1009551,3,32,367000,354000,-13000
1009551,4,NA,354000,354000,0
1009551,5,23,354000,332000,-22000
1009551,6,24,332000,308000,-24000
1009551,7,NA,308000,308000,0
1009551,8,NA,308000,308000,0
1009551,9,NA,308000,308000,0
1009551,10,NA,308000,308000,0
1009551,11,NA,308000,308000,0
1009551,12,NA,308000,308000,0
1009551,13,NA,308000,308000,0
1009551,14,40,308000,296000,-12000
1009551,15,NA,296000,296000,0
1009551,16,NA,296000,296000,0
1009551,17,39,296000,293000,-3000
1009551,18,23,293000,285000,-8000
1009551,19,NA,285000,285000,0
1009551,20,NA,285000,285000,0
1009551,21,NA,285000,285000,0
1009551,22,NA,285000,285000,0
1009551,23,15,285000,268000,-17000
1009551,24,21,268000,249000,-19000
1009708,1,57,309000,325000,16000
1009708,2,76,325000,365000,40000
1009708,3,53,365000,399000,34000
1009708,4,84,399000,446000,47000
1009708,5,75,446000,490000,44000
1009708,6,70,490000,523000,33000
1009708,7,55,523000,535000,12000
1009708,8,72,535000,547000,12000
1009708,9,33,547000,528000,-19000
1009708,10,36,528000,496000,-32000
1009708,11,47,496000,467000,-29000
1009708,12,70,467000,460000,-7000
1009708,13,24,460000,436000,-24000
1009708,14,70,436000,440000,4000
1009708,15,NA,440000,440000,0
1009708,16,58,440000,448000,8000
1009708,17,60,448000,457000,9000
1009708,18,58,457000,465000,8000
1009708,19,77,465000,487000,22000
1009708,20,63,487000,502000,15000
1009708,21,52,502000,506000,4000
1009708,22,49,506000,499000,-7000
1009708,23,43,499000,482000,-17000
1009708,24,33,482000,451000,-31000
1010174,1,64,492000,497000,5000
1010174,2,59,497000,503000,6000
1010174,3,NA,503000,503000,0
1010174,4,NA,503000,503000,0
1010174,5,NA,503000,503000,0
1010174,6,NA,503000,503000,0
1010174,7,NA,503000,503000,0
1010174,8,NA,503000,503000,0
1010174,9,NA,503000,503000,0
1010174,10,NA,503000,503000,0
1010174,11,NA,503000,503000,0
1010174,12,NA,503000,503000,0
1010174,13,NA,503000,503000,0
1010174,14,NA,503000,503000,0
1010174,15,NA,503000,503000,0
1010174,16,NA,503000,503000,0
1010174,17,NA,503000,503000,0
1010174,18,NA,503000,503000,0
1010174,19,NA,503000,503000,0
1010174,20,NA,503000,503000,0
1010174,21,NA,503000,503000,0
1010174,22,NA,503000,503000,0
1010174,23,NA,503000,503000,0
1010174,24,NA,503000,503000,0
1010708,1,NA,311000,311000,0
1010708,2,18,311000,297000,-14000
1010708,3,NA,297000,297000,0
1010708,4,NA,297000,297000,0
1010708,5,NA,297000,297000,0
1010708,6,NA,297000,297000,0
1010708,7,NA,297000,297000,0
1010708,8,NA,297000,297000,0
1010708,9,61,297000,306000,9000
1010708,10,81,306000,344000,38000
1010708,11,48,344000,374000,30000
1010708,12,51,374000,397000,23000
1010708,13,38,397000,405000,8000
1010708,14,NA,405000,405000,0
1010708,15,25,405000,390000,-15000
1010708,16,51,390000,380000,-10000
1010708,17,NA,380000,380000,0
1010708,18,NA,380000,380000,0
1010708,19,NA,380000,380000,0
1010708,20,NA,380000,380000,0
1010708,21,NA,380000,380000,0
1010708,22,NA,380000,380000,0
1010708,23,NA,380000,380000,0
1010708,24,NA,380000,380000,0
1011243,1,24,345000,333000,-12000
1011243,2,NA,333000,333000,0
1011243,3,NA,333000,333000,0
1011243,4,NA,333000,333000,0
1011243,5,NA,333000,333000,0
1011243,6,NA,333000,333000,0
1011243,7,NA,333000,333000,0
1011243,8,NA,333000,333000,0
1011243,9,21,333000,311000,-22000
1011243,10,52,311000,307000,-4000
1011243,11,NA,307000,307000,0
1011243,12,64,307000,325000,18000
1011243,13,NA,325000,325000,0
1011243,14,NA,325000,325000,0
1011243,15,NA,325000,325000,0
1011243,16,NA,325000,325000,0
1011243,17,NA,325000,325000,0
1011243,18,NA,325000,325000,0
1011243,19,NA,325000,325000,0
1011243,20,NA,325000,325000,0
1011243,21,NA,325000,325000,0
1011243,22,NA,325000,325000,0
1011243,23,NA,325000,325000,0
1011243,24,NA,325000,325000,0
1011437,1,NA,410000,410000,0
1011437,2,NA,410000,410000,0
1011437,3,NA,410000,410000,0
1011437,4,NA,410000,410000,0
1011437,5,NA,410000,410000,0
1011437,6,NA,410000,410000,0
1011437,7,NA,410000,410000,0
1011437,8,NA,410000,410000,0
1011437,9,26,410000,393000,-17000
1011437,10,41,393000,377000,-16000
1011437,11,NA,377000,377000,0
1011437,12,NA,377000,377000,0
1011437,13,NA,377000,377000,0
1011437,14,NA,377000,377000,0
1011437,15,NA,377000,377000,0
1011437,16,NA,377000,377000,0
1011437,17,NA,377000,377000,0
1011437,18,NA,377000,377000,0
1011437,19,NA,377000,377000,0
1011437,20,NA,377000,377000,0
1011437,21,NA,377000,377000,0
1011437,22,NA,377000,377000,0
1011437,23,NA,377000,377000,0
1011437,24,NA,377000,377000,0
1011449,1,NA,246000,246000,0
1011449,2,NA,246000,246000,0
1011449,3,NA,246000,246000,0
1011449,4,NA,246000,246000,0
1011449,5,NA,246000,246000,0
1011449,6,37,246000,252000,6000
1011449,7,NA,252000,252000,0
1011449,8,24,252000,252000,0
1011449,9,NA,252000,252000,0
1011449,10,NA,252000,252000,0
1011449,11,NA,252000,252000,0
1011449,12,NA,252000,252000,0
1011449,13,32,252000,253000,1000
1011449,14,NA,253000,253000,0
1011449,15,NA,253000,253000,0
1011449,16,NA,253000,253000,0
1011449,17,NA,253000,253000,0
1011449,18,NA,253000,253000,0
1011449,19,NA,253000,253000,0
1011449,20,NA,253000,253000,0
1011449,21,NA,253000,253000,0
1011449,22,NA,253000,253000,0
1011449,23,29,253000,252000,-1000
1011449,24,NA,252000,252000,0
1011583,1,72,386000,406000,20000
1011583,2,19,406000,401000,-5000
1011583,3,44,401000,394000,-7000
1011583,4,NA,394000,394000,0
1011583,5,NA,394000,394000,0
1011583,6,NA,394000,394000,0
1011583,7,NA,394000,394000,0
1011583,8,NA,394000,394000,0
1011583,9,NA,394000,394000,0
1011583,10,NA,394000,394000,0
1011583,11,42,394000,385000,-9000
1011583,12,37,385000,372000,-13000
1011583,13,83,372000,391000,19000
1011583,14,NA,391000,391000,0
1011583,15,NA,391000,391000,0
1011583,16,NA,391000,391000,0
1011583,17,47,391000,407000,16000
1011583,18,62,407000,427000,20000
1011583,19,41,427000,432000,5000
1011583,20,2,432000,399000,-33000
1011583,21,NA,399000,399000,0
1011583,22,32,399000,364000,-35000
1011583,23,49,364000,346000,-18000
1011583,24,50,346000,341000,-5000
1011589,1,NA,410000,410000,0
1011589,2,NA,410000,410000,0
1011589,3,NA,410000,410000,0
1011589,4,NA,410000,410000,0
1011589,5,NA,410000,410000,0
1011589,6,NA,410000,410000,0
1011589,7,NA,410000,410000,0
1011589,8,NA,410000,410000,0
1011589,9,NA,410000,410000,0
1011589,10,NA,410000,410000,0
1011589,11,NA,410000,410000,0
1011589,12,NA,410000,410000,0
1011589,13,NA,410000,410000,0
1011589,14,NA,410000,410000,0
1011589,15,NA,410000,410000,0
1011589,16,42,410000,406000,-4000
1011589,17,65,406000,414000,8000
1011589,18,49,414000,420000,6000
1011589,19,55,420000,427000,7000
1011589,20,50,427000,432000,5000
1011589,21,65,432000,444000,12000
1011589,22,43,444000,443000,-1000
1011589,23,62,443000,449000,6000
1011589,24,79,449000,468000,19000
1011633,1,NA,200000,200000,0
1011633,2,NA,200000,200000,0
1011633,3,NA,200000,200000,0
1011633,4,NA,200000,200000,0
1011633,5,NA,200000,200000,0
1011633,6,NA,200000,200000,0
1011633,7,NA,200000,200000,0
1011633,8,NA,200000,200000,0
1011633,9,NA,200000,200000,0
1011633,10,NA,200000,200000,0
1011633,11,NA,200000,200000,0
1011633,12,NA,200000,200000,0
1011633,13,NA,200000,200000,0
1011633,14,NA,200000,200000,0
1011633,15,NA,200000,200000,0
1011633,16,NA,200000,200000,0
1011633,17,NA,200000,200000,0
1011633,18,NA,200000,200000,0
1011633,19,NA,200000,200000,0
1011633,20,NA,200000,200000,0
1011633,21,NA,200000,200000,0
1011633,22,NA,200000,200000,0
1011633,23,NA,200000,200000,0
1011633,24,NA,200000,200000,0
1011637,1,NA,200000,200000,0
1011637,2,NA,200000,200000,0
1011637,3,NA,200000,200000,0
1011637,4,NA,200000,200000,0
1011637,5,NA,200000,200000,0
1011637,6,NA,200000,200000,0
1011637,7,NA,200000,200000,0
1011637,8,NA,200000,200000,0
1011637,9,NA,200000,200000,0
1011637,10,NA,200000,200000,0
1011637,11,NA,200000,200000,0
1011637,12,NA,200000,200000,0
1011637,13,NA,200000,200000,0
1011637,14,NA,200000,200000,0
1011637,15,NA,200000,200000,0
1011637,16,NA,200000,200000,0
1011637,17,NA,200000,200000,0
1011637,18,NA,200000,200000,0
1011637,19,NA,200000,200000,0
1011637,20,NA,200000,200000,0
1011637,21,NA,200000,200000,0
1011637,22,NA,200000,200000,0
1011637,23,NA,200000,200000,0
1011637,24,NA,200000,200000,0
1011640,1,90,553000,572000,19000
1011640,2,42,572000,569000,-3000
1011640,3,68,569000,567000,-2000
1011640,4,69,567000,567000,0
1011640,5,67,567000,567000,0
1011640,6,38,567000,546000,-21000
1011640,7,98,546000,559000,13000
1011640,8,96,559000,589000,30000
1011640,9,74,589000,611000,22000
1011640,10,86,611000,634000,23000
1011640,11,84,634000,656000,22000
1011640,12,77,656000,664000,8000
1011640,13,60,664000,653000,-11000
1011640,14,34,653000,619000,-34000
1011640,15,NA,619000,619000,0
1011640,16,39,619000,570000,-49000
1011640,17,37,570000,518000,-52000
1011640,18,NA,518000,518000,0
1011640,19,82,518000,501000,-17000
1011640,20,58,501000,494000,-7000
1011640,21,100,494000,524000,30000
1011640,22,107,524000,577000,53000
1011640,23,45,577000,594000,17000
1011640,24,46,594000,582000,-12000
1011647,1,NA,203000,203000,0
1011647,2,NA,203000,203000,0
1011647,3,NA,203000,203000,0
1011647,4,NA,203000,203000,0
1011647,5,NA,203000,203000,0
1011647,6,NA,203000,203000,0
1011647,7,NA,203000,203000,0
1011647,8,NA,203000,203000,0
1011647,9,23,203000,202000,-1000
1011647,10,48,202000,218000,16000
1011647,11,5,218000,215000,-3000
1011647,12,59,215000,236000,21000
1011647,13,52,236000,265000,29000
1011647,14,28,265000,283000,18000
1011647,15,NA,283000,283000,0
1011647,16,NA,283000,283000,0
1011647,17,NA,283000,283000,0
1011647,18,NA,283000,283000,0
1011647,19,NA,283000,283000,0
1011647,20,NA,283000,283000,0
1011647,21,NA,283000,283000,0
1011647,22,NA,283000,283000,0
1011647,23,NA,283000,283000,0
1011647,24,NA,283000,283000,0
1011659,1,73,492000,504000,12000
1011659,2,63,504000,516000,12000
1011659,3,80,516000,539000,23000
1011659,4,48,539000,541000,2000
1011659,5,64,541000,542000,1000
1011659,6,66,542000,544000,2000
1011659,7,29,544000,518000,-26000
1011659,8,NA,518000,518000,0
1011659,9,NA,518000,518000,0
1011659,10,50,518000,493000,-25000
1011659,11,51,493000,473000,-20000
1011659,12,21,473000,436000,-37000
1011659,13,61,436000,421000,-15000
1011659,14,54,421000,421000,0
1011659,15,NA,421000,421000,0
1011659,16,NA,421000,421000,0
1011659,17,NA,421000,421000,0
1011659,18,NA,421000,421000,0
1011659,19,NA,421000,421000,0
1011659,20,NA,421000,421000,0
1011659,21,NA,421000,421000,0
1011659,22,NA,421000,421000,0
1011659,23,48,421000,418000,-3000
1011659,24,95,418000,448000,30000
1011718,1,NA,200000,200000,0
1011718,2,NA,200000,200000,0
1011718,3,NA,200000,200000,0
1011718,4,NA,200000,200000,0
1011718,5,NA,200000,200000,0
1011718,6,NA,200000,200000,0
1011718,7,NA,200000,200000,0
1011718,8,NA,200000,200000,0
1011718,9,NA,200000,200000,0
1011718,10,NA,200000,200000,0
1011718,11,NA,200000,200000,0
1011718,12,NA,200000,200000,0
1011718,13,NA,200000,200000,0
1011718,14,NA,200000,200000,0
1011718,15,NA,200000,200000,0
1011718,16,NA,200000,200000,0
1011718,17,NA,200000,200000,0
1011718,18,NA,200000,200000,0
1011718,19,NA,200000,200000,0
1011718,20,NA,200000,200000,0
1011718,21,NA,200000,200000,0
1011718,22,NA,200000,200000,0
1011718,23,NA,200000,200000,0
1011718,24,NA,200000,200000,0
1011755,1,56,371000,381000,10000
1011755,2,37,381000,383000,2000
1011755,3,46,383000,385000,2000
1011755,4,40,385000,382000,-3000
1011755,5,35,382000,373000,-9000
1011755,6,NA,373000,373000,0
1011755,7,NA,373000,373000,0
1011755,8,NA,373000,373000,0
1011755,9,NA,373000,373000,0
1011755,10,NA,373000,373000,0
1011755,11,NA,373000,373000,0
1011755,12,NA,373000,373000,0
1011755,13,NA,373000,373000,0
1011755,14,NA,373000,373000,0
1011755,15,NA,373000,373000,0
1011755,16,NA,373000,373000,0
1011755,17,NA,373000,373000,0
1011755,18,NA,373000,373000,0
1011755,19,NA,373000,373000,0
1011755,20,NA,373000,373000,0
1011755,21,NA,373000,373000,0
1011755,22,NA,373000,373000,0
1011755,23,NA,373000,373000,0
1011755,24,NA,373000,373000,0
1011771,1,NA,458000,458000,0
1011771,2,NA,458000,458000,0
1011771,3,NA,458000,458000,0
1011771,4,NA,458000,458000,0
1011771,5,NA,458000,458000,0
1011771,6,NA,458000,458000,0
1011771,7,NA,458000,458000,0
1011771,8,73,458000,471000,13000
1011771,9,30,471000,462000,-9000
1011771,10,NA,462000,462000,0
1011771,11,NA,462000,462000,0
1011771,12,NA,462000,462000,0
1011771,13,NA,462000,462000,0
1011771,14,NA,462000,462000,0
1011771,15,NA,462000,462000,0
1011771,16,NA,462000,462000,0
1011771,17,59,462000,459000,-3000
1011771,18,NA,459000,459000,0
1011771,19,NA,459000,459000,0
1011771,20,NA,459000,459000,0
1011771,21,NA,459000,459000,0
1011771,22,NA,459000,459000,0
1011771,23,27,459000,437000,-22000
1011771,24,38,437000,411000,-26000
1011803,1,NA,445000,445000,0
1011803,2,NA,445000,445000,0
1011803,3,NA,445000,445000,0
1011803,4,NA,445000,445000,0
1011803,5,82,445000,466000,21000
1011803,6,46,466000,476000,10000
1011803,7,14,476000,451000,-25000
1011803,8,31,451000,419000,-32000
1011803,9,52,419000,399000,-20000
1011803,10,76,399000,406000,7000
1011803,11,61,406000,423000,17000
1011803,12,64,423000,448000,25000
1011803,13,69,448000,474000,26000
1011803,14,108,474000,528000,54000
1011803,15,NA,528000,528000,0
1011803,16,60,528000,557000,29000
1011803,17,99,557000,596000,39000
1011803,18,38,596000,595000,-1000
1011803,19,64,595000,586000,-9000
1011803,20,48,586000,562000,-24000
1011803,21,52,562000,536000,-26000
1011803,22,14,536000,484000,-52000
1011803,23,38,484000,442000,-42000
1011803,24,94,442000,444000,2000
1011839,1,31,271000,271000,0
1011839,2,35,271000,273000,2000
1011839,3,NA,273000,273000,0
1011839,4,NA,273000,273000,0
1011839,5,NA,273000,273000,0
1011839,6,NA,273000,273000,0
1011839,7,NA,273000,273000,0
1011839,8,NA,273000,273000,0
1011839,9,12,273000,260000,-13000
1011839,10,47,260000,263000,3000
1011839,11,13,263000,252000,-11000
1011839,12,43,252000,254000,2000
1011839,13,25,254000,253000,-1000
1011839,14,NA,253000,253000,0
1011839,15,23,253000,249000,-4000
1011839,16,2,249000,226000,-23000
1011839,17,21,226000,208000,-18000
1011839,18,NA,208000,208000,0
1011839,19,NA,208000,208000,0
1011839,20,24,208000,200000,-8000
1011839,21,21,200000,200000,0
1011839,22,25,200000,200000,0
1011839,23,21,200000,200000,0
1011839,24,22,200000,200000,0
1011929,1,NA,201000,201000,0
1011929,2,NA,201000,201000,0
1011929,3,NA,201000,201000,0
1011929,4,NA,201000,201000,0
1011929,5,NA,201000,201000,0
1011929,6,NA,201000,201000,0
1011929,7,NA,201000,201000,0
1011929,8,NA,201000,201000,0
1011929,9,NA,201000,201000,0
1011929,10,NA,201000,201000,0
1011929,11,NA,201000,201000,0
1011929,12,NA,201000,201000,0
1011929,13,NA,201000,201000,0
1011929,14,NA,201000,201000,0
1011929,15,NA,201000,201000,0
1011929,16,NA,201000,201000,0
1011929,17,NA,201000,201000,0
1011929,18,NA,201000,201000,0
1011929,19,NA,201000,201000,0
1011929,20,NA,201000,201000,0
1011929,21,NA,201000,201000,0
1011929,22,NA,201000,201000,0
1011929,23,NA,201000,201000,0
1011929,24,NA,201000,201000,0
1011936,1,96,613000,632000,19000
1011936,2,61,632000,637000,5000
1011936,3,69,637000,636000,-1000
1011936,4,55,636000,620000,-16000
1011936,5,52,620000,594000,-26000
1011936,6,33,594000,551000,-43000
1011936,7,NA,551000,551000,0
1011936,8,89,551000,543000,-8000
1011936,9,55,543000,533000,-10000
1011936,10,58,533000,526000,-7000
1011936,11,102,526000,552000,26000
1011936,12,NA,552000,552000,0
1011936,13,83,552000,582000,30000
1011936,14,64,582000,599000,17000
1011936,15,91,599000,623000,24000
1011936,16,72,623000,635000,12000
1011936,17,71,635000,636000,1000
1011936,18,97,636000,650000,14000
1011936,19,63,650000,649000,-1000
1011936,20,63,649000,638000,-11000
1011936,21,NA,638000,638000,0
1011936,22,NA,638000,638000,0
1011936,23,NA,638000,638000,0
1011936,24,NA,638000,638000,0
1011954,1,NA,504000,504000,0
1011954,2,NA,504000,504000,0
1011954,3,NA,504000,504000,0
1011954,4,NA,504000,504000,0
1011954,5,NA,504000,504000,0
1011954,6,NA,504000,504000,0
1011954,7,NA,504000,504000,0
1011954,8,NA,504000,504000,0
1011954,9,NA,504000,504000,0
1011954,10,NA,504000,504000,0
1011954,11,32,504000,483000,-21000
1011954,12,NA,483000,483000,0
1011954,13,NA,483000,483000,0
1011954,14,NA,483000,483000,0
1011954,15,34,483000,453000,-30000
1011954,16,NA,453000,453000,0
1011954,17,NA,453000,453000,0
1011954,18,91,453000,459000,6000
1011954,19,29,459000,447000,-12000
1011954,20,81,447000,461000,14000
1011954,21,49,461000,468000,7000
1011954,22,55,468000,472000,4000
1011954,23,NA,472000,472000,0
1011954,24,68,472000,478000,6000
1011981,1,NA,363000,363000,0
1011981,2,NA,363000,363000,0
1011981,3,NA,363000,363000,0
1011981,4,NA,363000,363000,0
1011981,5,NA,363000,363000,0
1011981,6,NA,363000,363000,0
1011981,7,NA,363000,363000,0
1011981,8,NA,363000,363000,0
1011981,9,NA,363000,363000,0
1011981,10,NA,363000,363000,0
1011981,11,69,363000,381000,18000
1011981,12,NA,381000,381000,0
1011981,13,78,381000,417000,36000
1011981,14,NA,417000,417000,0
1011981,15,53,417000,445000,28000
1011981,16,51,445000,460000,15000
1011981,17,75,460000,481000,21000
1011981,18,61,481000,494000,13000
1011981,19,54,494000,496000,2000
1011981,20,81,496000,513000,17000
1011981,21,33,513000,504000,-9000
1011981,22,62,504000,498000,-6000
1011981,23,46,498000,484000,-14000
1011981,24,46,484000,466000,-18000
1011985,1,NA,469000,469000,0
1011985,2,NA,469000,469000,0
1011985,3,44,469000,460000,-9000
1011985,4,89,460000,480000,20000
1011985,5,64,480000,499000,19000
1011985,6,14,499000,481000,-18000
1011985,7,NA,481000,481000,0
1011985,8,44,481000,458000,-23000
1011985,9,50,458000,441000,-17000
1011985,10,43,441000,420000,-21000
1011985,11,49,420000,410000,-10000
1011985,12,56,410000,412000,2000
1011985,13,2,412000,381000,-31000
1011985,14,5,381000,336000,-45000
1011985,15,NA,336000,336000,0
1011985,16,37,336000,305000,-31000
1011985,17,NA,305000,305000,0
1011985,18,9,305000,266000,-39000
1011985,19,NA,266000,266000,0
1011985,20,NA,266000,266000,0
1011985,21,NA,266000,266000,0
1011985,22,NA,266000,266000,0
1011985,23,NA,266000,266000,0
1011985,24,NA,266000,266000,0
1011994,1,94,491000,519000,28000
1011994,2,36,519000,521000,2000
1011994,3,98,521000,549000,28000
1011994,4,77,549000,575000,26000
1011994,5,86,575000,604000,29000
1011994,6,59,604000,611000,7000
1011994,7,70,611000,614000,3000
1011994,8,86,614000,623000,9000
1011994,9,55,623000,613000,-10000
1011994,10,63,613000,600000,-13000
1011994,11,76,600000,596000,-4000
1011994,12,NA,596000,596000,0
1011994,13,66,596000,590000,-6000
1011994,14,34,590000,564000,-26000
1011994,15,40,564000,529000,-35000
1011994,16,41,529000,493000,-36000
1011994,17,45,493000,460000,-33000
1011994,18,48,460000,438000,-22000
1011994,19,NA,438000,438000,0
1011994,20,61,438000,434000,-4000
1011994,21,50,434000,434000,0
1011994,22,NA,434000,434000,0
1011994,23,NA,434000,434000,0
1011994,24,55,434000,436000,2000
1012014,1,117,785000,805000,20000
1012014,2,61,805000,796000,-9000
1012014,3,56,796000,762000,-34000
1012014,4,109,762000,754000,-8000
1012014,5,101,754000,759000,5000
1012014,6,53,759000,737000,-22000
1012014,7,113,737000,746000,9000
1012014,8,99,746000,761000,15000
1012014,9,104,761000,778000,17000
1012014,10,115,778000,805000,27000
1012014,11,105,805000,831000,26000
1012014,12,NA,831000,831000,0
1012014,13,97,831000,841000,10000
1012014,14,72,841000,832000,-9000
1012014,15,128,832000,843000,11000
1012014,16,NA,843000,843000,0
1012014,17,NA,843000,843000,0
1012014,18,NA,843000,843000,0
1012014,19,70,843000,826000,-17000
1012014,20,92,826000,811000,-15000
1012014,21,89,811000,799000,-12000
1012014,22,94,799000,791000,-8000
1012014,23,87,791000,780000,-11000
1012014,24,92,780000,772000,-8000
1012048,1,NA,200000,200000,0
1012048,2,NA,200000,200000,0
1012048,3,NA,200000,200000,0
1012048,4,NA,200000,200000,0
1012048,5,NA,200000,200000,0
1012048,6,NA,200000,200000,0
1012048,7,NA,200000,200000,0
1012048,8,NA,200000,200000,0
1012048,9,NA,200000,200000,0
1012048,10,NA,200000,200000,0
1012048,11,NA,200000,200000,0
1012048,12,NA,200000,200000,0
1012048,13,NA,200000,200000,0
1012048,14,NA,200000,200000,0
1012048,15,NA,200000,200000,0
1012048,16,NA,200000,200000,0
1012048,17,NA,200000,200000,0
1012048,18,NA,200000,200000,0
1012048,19,NA,200000,200000,0
1012048,20,NA,200000,200000,0
1012048,21,NA,200000,200000,0
1012048,22,NA,200000,200000,0
1012048,23,NA,200000,200000,0
1012048,24,NA,200000,200000,0
1012127,1,NA,200000,200000,0
1012127,2,NA,200000,200000,0
1012127,3,NA,200000,200000,0
1012127,4,NA,200000,200000,0
1012127,5,NA,200000,200000,0
1012127,6,NA,200000,200000,0
1012127,7,NA,200000,200000,0
1012127,8,NA,200000,200000,0
1012127,9,NA,200000,200000,0
1012127,10,NA,200000,200000,0
1012127,11,NA,200000,200000,0
1012127,12,NA,200000,200000,0
1012127,13,NA,200000,200000,0
1012127,14,NA,200000,200000,0
1012127,15,NA,200000,200000,0
1012127,16,NA,200000,200000,0
1012127,17,NA,200000,200000,0
1012127,18,NA,200000,200000,0
1012127,19,NA,200000,200000,0
1012127,20,55,200000,222000,22000
1012127,21,59,222000,261000,39000
1012127,22,NA,261000,261000,0
1012127,23,NA,261000,261000,0
1012127,24,2,261000,265000,4000
1012144,1,NA,434000,434000,0
1012144,2,NA,434000,434000,0
1012144,3,NA,434000,434000,0
1012144,4,NA,434000,434000,0
1012144,5,NA,434000,434000,0
1012144,6,NA,434000,434000,0
1012144,7,NA,434000,434000,0
1012144,8,NA,434000,434000,0
1012144,9,NA,434000,434000,0
1012144,10,NA,434000,434000,0
1012144,11,NA,434000,434000,0
1012144,12,NA,434000,434000,0
1012144,13,NA,434000,434000,0
1012144,14,NA,434000,434000,0
1012144,15,NA,434000,434000,0
1012144,16,NA,434000,434000,0
1012144,17,NA,434000,434000,0
1012144,18,NA,434000,434000,0
1012144,19,NA,434000,434000,0
1012144,20,NA,434000,434000,0
1012144,21,NA,434000,434000,0
1012144,22,NA,434000,434000,0
1012144,23,NA,434000,434000,0
1012144,24,34,434000,420000,-14000
1012210,1,29,200000,204000,4000
1012210,2,15,204000,201000,-3000
1012210,3,11,201000,200000,-1000
1012210,4,NA,200000,200000,0
1012210,5,64,200000,213000,13000
1012210,6,19,213000,223000,10000
1012210,7,NA,223000,223000,0
1012210,8,NA,223000,223000,0
1012210,9,NA,223000,223000,0
1012210,10,NA,223000,223000,0
1012210,11,NA,223000,223000,0
1012210,12,NA,223000,223000,0
1012210,13,NA,223000,223000,0
1012210,14,NA,223000,223000,0
1012210,15,NA,223000,223000,0
1012210,16,NA,223000,223000,0
1012210,17,NA,223000,223000,0
1012210,18,NA,223000,223000,0
1012210,19,NA,223000,223000,0
1012210,20,NA,223000,223000,0
1012210,21,NA,223000,223000,0
1012210,22,47,223000,243000,20000
1012210,23,NA,243000,243000,0
1012210,24,NA,243000,243000,0
1012218,1,70,213000,246000,33000
1012218,2,55,246000,290000,44000
1012218,3,67,290000,343000,53000
1012218,4,NA,343000,343000,0
1012218,5,47,343000,380000,37000
1012218,6,67,380000,415000,35000
1012218,7,75,415000,450000,35000
1012218,8,45,450000,464000,14000
1012218,9,80,464000,488000,24000
1012218,10,46,488000,493000,5000
1012218,11,56,493000,492000,-1000
1012218,12,42,492000,478000,-14000
1012218,13,71,478000,480000,2000
1012218,14,NA,480000,480000,0
1012218,15,68,480000,489000,9000
1012218,16,57,489000,496000,7000
1012218,17,38,496000,486000,-10000
1012218,18,47,486000,472000,-14000
1012218,19,39,472000,449000,-23000
1012218,20,68,449000,445000,-4000
1012218,21,NA,445000,445000,0
1012218,22,65,445000,452000,7000
1012218,23,56,452000,461000,9000
1012218,24,64,461000,472000,11000
1012386,1,NA,200000,200000,0
1012386,2,57,200000,225000,25000
1012386,3,15,225000,235000,10000
1012386,4,32,235000,244000,9000
1012386,5,51,244000,265000,21000
1012386,6,69,265000,304000,39000
1012386,7,73,304000,353000,49000
1012386,8,69,353000,404000,51000
1012386,9,72,404000,452000,48000
1012386,10,47,452000,472000,20000
1012386,11,26,472000,459000,-13000
1012386,12,60,459000,451000,-8000
1012386,13,40,451000,434000,-17000
1012386,14,17,434000,401000,-33000
1012386,15,NA,401000,401000,0
1012386,16,25,401000,366000,-35000
1012386,17,NA,366000,366000,0
1012386,18,NA,366000,366000,0
1012386,19,NA,366000,366000,0
1012386,20,NA,366000,366000,0
1012386,21,NA,366000,366000,0
1012386,22,NA,366000,366000,0
1012386,23,NA,366000,366000,0
1012386,24,NA,366000,366000,0
1012521,1,NA,200000,200000,0
1012521,2,NA,200000,200000,0
1012521,3,NA,200000,200000,0
1012521,4,NA,200000,200000,0
1012521,5,NA,200000,200000,0
1012521,6,NA,200000,200000,0
1012521,7,NA,200000,200000,0
1012521,8,NA,200000,200000,0
1012521,9,NA,200000,200000,0
1012521,10,NA,200000,200000,0
1012521,11,NA,200000,200000,0
1012521,12,NA,200000,200000,0
1012521,13,NA,200000,200000,0
1012521,14,NA,200000,200000,0
1012521,15,NA,200000,200000,0
1012521,16,NA,200000,200000,0
1012521,17,NA,200000,200000,0
1012521,18,NA,200000,200000,0
1012521,19,NA,200000,200000,0
1012521,20,NA,200000,200000,0
1012521,21,NA,200000,200000,0
1012521,22,NA,200000,200000,0
1012521,23,NA,200000,200000,0
1012521,24,NA,200000,200000,0
1012805,1,65,471000,479000,8000
1012805,2,43,479000,476000,-3000
1012805,3,42,476000,464000,-12000
1012805,4,NA,464000,464000,0
1012805,5,NA,464000,464000,0
1012805,6,NA,464000,464000,0
1012805,7,58,464000,457000,-7000
1012805,8,73,457000,468000,11000
1012805,9,69,468000,484000,16000
1012805,10,93,484000,521000,37000
1012805,11,79,521000,557000,36000
1012805,12,100,557000,602000,45000
1012805,13,NA,602000,602000,0
1012805,14,49,602000,615000,13000
1012805,15,82,615000,625000,10000
1012805,16,64,625000,622000,-3000
1012805,17,95,622000,632000,10000
1012805,18,72,632000,635000,3000
1012805,19,64,635000,631000,-4000
1012805,20,69,631000,624000,-7000
1012805,21,66,624000,614000,-10000
1012805,22,87,614000,616000,2000
1012805,23,73,616000,618000,2000
1012805,24,NA,618000,618000,0
1012807,1,36,746000,709000,-37000
1012807,2,52,709000,661000,-48000
1012807,3,52,661000,611000,-50000
1012807,4,NA,611000,611000,0
1012807,5,NA,611000,611000,0
1012807,6,NA,611000,611000,0
1012807,7,NA,611000,611000,0
1012807,8,NA,611000,611000,0
1012807,9,NA,611000,611000,0
1012807,10,57,611000,569000,-42000
1012807,11,NA,569000,569000,0
1012807,12,NA,569000,569000,0
1012807,13,NA,569000,569000,0
1012807,14,NA,569000,569000,0
1012807,15,NA,569000,569000,0
1012807,16,NA,569000,569000,0
1012807,17,NA,569000,569000,0
1012807,18,NA,569000,569000,0
1012807,19,NA,569000,569000,0
1012807,20,NA,569000,569000,0
1012807,21,NA,569000,569000,0
1012807,22,NA,569000,569000,0
1012807,23,NA,569000,569000,0
1012807,24,NA,569000,569000,0
1012817,1,NA,411000,411000,0
1012817,2,NA,411000,411000,0
1012817,3,NA,411000,411000,0
1012817,4,NA,411000,411000,0
1012817,5,NA,411000,411000,0
1012817,6,NA,411000,411000,0
1012817,7,NA,411000,411000,0
1012817,8,NA,411000,411000,0
1012817,9,NA,411000,411000,0
1012817,10,NA,411000,411000,0
1012817,11,NA,411000,411000,0
1012817,12,NA,411000,411000,0
1012817,13,NA,411000,411000,0
1012817,14,NA,411000,411000,0
1012817,15,NA,411000,411000,0
1012817,16,NA,411000,411000,0
1012817,17,NA,411000,411000,0
1012817,18,NA,411000,411000,0
1012817,19,NA,411000,411000,0
1012817,20,NA,411000,411000,0
1012817,21,NA,411000,411000,0
1012817,22,NA,411000,411000,0
1012817,23,NA,411000,411000,0
1012817,24,NA,411000,411000,0
1012819,1,13,310000,293000,-17000
1012819,2,NA,293000,293000,0
1012819,3,NA,293000,293000,0
1012819,4,NA,293000,293000,0
1012819,5,NA,293000,293000,0
1012819,6,NA,293000,293000,0
1012819,7,NA,293000,293000,0
1012819,8,31,293000,278000,-15000
1012819,9,77,278000,300000,22000
1012819,10,30,300000,312000,12000
1012819,11,52,312000,331000,19000
1012819,12,NA,331000,331000,0
1012819,13,82,331000,374000,43000
1012819,14,36,374000,395000,21000
1012819,15,48,395000,405000,10000
1012819,16,58,405000,418000,13000
1012819,17,33,418000,412000,-6000
1012819,18,67,412000,418000,6000
1012819,19,54,418000,426000,8000
1012819,20,45,426000,427000,1000
1012819,21,57,427000,432000,5000
1012819,22,71,432000,449000,17000
1012819,23,47,449000,454000,5000
1012819,24,88,454000,479000,25000
1012825,1,62,561000,559000,-2000
1012825,2,54,559000,550000,-9000
1012825,3,54,550000,537000,-13000
1012825,4,67,537000,531000,-6000
1012825,5,78,531000,540000,9000
1012825,6,55,540000,542000,2000
1012825,7,65,542000,544000,2000
1012825,8,69,544000,550000,6000
1012825,9,56,550000,545000,-5000
1012825,10,32,545000,518000,-27000
1012825,11,54,518000,497000,-21000
1012825,12,58,497000,482000,-15000
1012825,13,NA,482000,482000,0
1012825,14,NA,482000,482000,0
1012825,15,NA,482000,482000,0
1012825,16,68,482000,483000,1000
1012825,17,76,483000,499000,16000
1012825,18,75,499000,522000,23000
1012825,19,55,522000,532000,10000
1012825,20,78,532000,547000,15000
1012825,21,81,547000,566000,19000
1012825,22,43,566000,559000,-7000
1012825,23,61,559000,550000,-9000
1012825,24,67,550000,543000,-7000
1012826,1,17,200000,200000,0
1012826,2,NA,200000,200000,0
1012826,3,NA,200000,200000,0
1012826,4,NA,200000,200000,0
1012826,5,NA,200000,200000,0
1012826,6,12,200000,200000,0
1012826,7,NA,200000,200000,0
1012826,8,NA,200000,200000,0
1012826,9,NA,200000,200000,0
1012826,10,NA,200000,200000,0
1012826,11,NA,200000,200000,0
1012826,12,NA,200000,200000,0
1012826,13,NA,200000,200000,0
1012826,14,NA,200000,200000,0
1012826,15,NA,200000,200000,0
1012826,16,NA,200000,200000,0
1012826,17,NA,200000,200000,0
1012826,18,NA,200000,200000,0
1012826,19,NA,200000,200000,0
1012826,20,NA,200000,200000,0
1012826,21,NA,200000,200000,0
1012826,22,NA,200000,200000,0
1012826,23,39,200000,200000,0
1012826,24,30,200000,200000,0
1012828,1,NA,290000,290000,0
1012828,2,NA,290000,290000,0
1012828,3,NA,290000,290000,0
1012828,4,NA,290000,290000,0
1012828,5,NA,290000,290000,0
1012828,6,NA,290000,290000,0
1012828,7,NA,290000,290000,0
1012828,8,NA,290000,290000,0
1012828,9,NA,290000,290000,0
1012828,10,NA,290000,290000,0
1012828,11,NA,290000,290000,0
1012828,12,NA,290000,290000,0
1012828,13,NA,290000,290000,0
1012828,14,NA,290000,290000,0
1012828,15,NA,290000,290000,0
1012828,16,NA,290000,290000,0
1012828,17,NA,290000,290000,0
1012828,18,NA,290000,290000,0
1012828,19,NA,290000,290000,0
1012828,20,NA,290000,290000,0
1012828,21,NA,290000,290000,0
1012828,22,NA,290000,290000,0
1012828,23,NA,290000,290000,0
1012828,24,47,290000,297000,7000
1012829,1,46,270000,281000,11000
1012829,2,NA,281000,281000,0
1012829,3,67,281000,314000,33000
1012829,4,66,314000,357000,43000
1012829,5,62,357000,398000,41000
1012829,6,22,398000,405000,7000
1012829,7,NA,405000,405000,0
1012829,8,NA,405000,405000,0
1012829,9,NA,405000,405000,0
1012829,10,54,405000,408000,3000
1012829,11,90,408000,436000,28000
1012829,12,90,436000,479000,43000
1012829,13,54,479000,504000,25000
1012829,14,63,504000,526000,22000
1012829,15,NA,526000,526000,0
1012829,16,61,526000,535000,9000
1012829,17,NA,535000,535000,0
1012829,18,NA,535000,535000,0
1012829,19,94,535000,556000,21000
1012829,20,57,556000,561000,5000
1012829,21,83,561000,577000,16000
1012829,22,NA,577000,577000,0
1012829,23,73,577000,589000,12000
1012829,24,87,589000,606000,17000
1012833,1,NA,339000,339000,0
1012833,2,NA,339000,339000,0
1012833,3,NA,339000,339000,0
1012833,4,NA,339000,339000,0
1012833,5,NA,339000,339000,0
1012833,6,NA,339000,339000,0
1012833,7,NA,339000,339000,0
1012833,8,NA,339000,339000,0
1012833,9,NA,339000,339000,0
1012833,10,78,339000,365000,26000
1012833,11,63,365000,399000,34000
1012833,12,40,399000,415000,16000
1012833,13,67,415000,436000,21000
1012833,14,23,436000,429000,-7000
1012833,15,NA,429000,429000,0
1012833,16,44,429000,415000,-14000
1012833,17,69,415000,419000,4000
1012833,18,67,419000,435000,16000
1012833,19,54,435000,447000,12000
1012833,20,45,447000,451000,4000
1012833,21,50,451000,450000,-1000
1012833,22,45,450000,440000,-10000
1012833,23,71,440000,446000,6000
1012833,24,91,446000,476000,30000
1012852,1,NA,367000,367000,0
1012852,2,NA,367000,367000,0
1012852,3,NA,367000,367000,0
1012852,4,NA,367000,367000,0
1012852,5,NA,367000,367000,0
1012852,6,NA,367000,367000,0
1012852,7,NA,367000,367000,0
1012852,8,2,367000,337000,-30000
1012852,9,NA,337000,337000,0
1012852,10,NA,337000,337000,0
1012852,11,19,337000,300000,-37000
1012852,12,NA,300000,300000,0
1012852,13,NA,300000,300000,0
1012852,14,NA,300000,300000,0
1012852,15,NA,300000,300000,0
1012852,16,NA,300000,300000,0
1012852,17,74,300000,304000,4000
1012852,18,NA,304000,304000,0
1012852,19,NA,304000,304000,0
1012852,20,NA,304000,304000,0
1012852,21,12,304000,291000,-13000
1012852,22,5,291000,265000,-26000
1012852,23,NA,265000,265000,0
1012852,24,88,265000,291000,26000
1012857,1,NA,455000,455000,0
1012857,2,NA,455000,455000,0
1012857,3,NA,455000,455000,0
1012857,4,NA,455000,455000,0
1012857,5,67,455000,464000,9000
1012857,6,54,464000,471000,7000
1012857,7,40,471000,465000,-6000
1012857,8,37,465000,447000,-18000
1012857,9,36,447000,424000,-23000
1012857,10,2,424000,373000,-51000
1012857,11,66,373000,359000,-14000
1012857,12,31,359000,344000,-15000
1012857,13,NA,344000,344000,0
1012857,14,NA,344000,344000,0
1012857,15,NA,344000,344000,0
1012857,16,NA,344000,344000,0
1012857,17,NA,344000,344000,0
1012857,18,NA,344000,344000,0
1012857,19,NA,344000,344000,0
1012857,20,NA,344000,344000,0
1012857,21,NA,344000,344000,0
1012857,22,37,344000,335000,-9000
1012857,23,51,335000,339000,4000
1012857,24,82,339000,372000,33000
1012860,1,77,440000,459000,19000
1012860,2,50,459000,471000,12000
1012860,3,54,471000,478000,7000
1012860,4,53,478000,479000,1000
1012860,5,78,479000,494000,15000
1012860,6,50,494000,497000,3000
1012860,7,69,497000,507000,10000
1012860,8,40,507000,499000,-8000
1012860,9,39,499000,479000,-20000
1012860,10,NA,479000,479000,0
1012860,11,62,479000,468000,-11000
1012860,12,47,468000,456000,-12000
1012860,13,NA,456000,456000,0
1012860,14,51,456000,450000,-6000
1012860,15,36,450000,435000,-15000
1012860,16,40,435000,419000,-16000
1012860,17,78,419000,428000,9000
1012860,18,49,428000,434000,6000
1012860,19,46,434000,434000,0
1012860,20,58,434000,441000,7000
1012860,21,84,441000,466000,25000
1012860,22,85,466000,501000,35000
1012860,23,9,501000,487000,-14000
1012860,24,74,487000,488000,1000
1012862,1,46,551000,538000,-13000
1012862,2,63,538000,529000,-9000
1012862,3,42,529000,510000,-19000
1012862,4,45,510000,487000,-23000
1012862,5,NA,487000,487000,0
1012862,6,NA,487000,487000,0
1012862,7,NA,487000,487000,0
1012862,8,NA,487000,487000,0
1012862,9,NA,487000,487000,0
1012862,10,NA,487000,487000,0
1012862,11,NA,487000,487000,0
1012862,12,NA,487000,487000,0
1012862,13,NA,487000,487000,0
1012862,14,NA,487000,487000,0
1012862,15,NA,487000,487000,0
1012862,16,NA,487000,487000,0
1012862,17,NA,487000,487000,0
1012862,18,62,487000,476000,-11000
1012862,19,73,476000,483000,7000
1012862,20,55,483000,487000,4000
1012862,21,40,487000,479000,-8000
1012862,22,34,479000,457000,-22000
1012862,23,NA,457000,457000,0
1012862,24,NA,457000,457000,0
1012863,1,NA,200000,200000,0
1012863,2,NA,200000,200000,0
1012863,3,NA,200000,200000,0
1012863,4,NA,200000,200000,0
1012863,5,NA,200000,200000,0
1012863,6,NA,200000,200000,0
1012863,7,NA,200000,200000,0
1012863,8,NA,200000,200000,0
1012863,9,31,200000,205000,5000
1012863,10,41,205000,220000,15000
1012863,11,NA,220000,220000,0
1012863,12,NA,220000,220000,0
1012863,13,NA,220000,220000,0
1012863,14,NA,220000,220000,0
1012863,15,NA,220000,220000,0
1012863,16,NA,220000,220000,0
1012863,17,NA,220000,220000,0
1012863,18,NA,220000,220000,0
1012863,19,NA,220000,220000,0
1012863,20,NA,220000,220000,0
1012863,21,NA,220000,220000,0
1012863,22,NA,220000,220000,0
1012863,23,NA,220000,220000,0
1012863,24,NA,220000,220000,0
1012879,1,NA,200000,200000,0
1012879,2,NA,200000,200000,0
1012879,3,NA,200000,200000,0
1012879,4,NA,200000,200000,0
1012879,5,NA,200000,200000,0
1012879,6,NA,200000,200000,0
1012879,7,NA,200000,200000,0
1012879,8,NA,200000,200000,0
1012879,9,NA,200000,200000,0
1012879,10,NA,200000,200000,0
1012879,11,NA,200000,200000,0
1012879,12,NA,200000,200000,0
1012879,13,NA,200000,200000,0
1012879,14,NA,200000,200000,0
1012879,15,NA,200000,200000,0
1012879,16,NA,200000,200000,0
1012879,17,NA,200000,200000,0
1012879,18,NA,200000,200000,0
1012879,19,NA,200000,200000,0
1012879,20,NA,200000,200000,0
1012879,21,NA,200000,200000,0
1012879,22,NA,200000,200000,0
1012879,23,NA,200000,200000,0
1012879,24,NA,200000,200000,0
1012881,1,NA,200000,200000,0
1012881,2,NA,200000,200000,0
1012881,3,NA,200000,200000,0
1012881,4,NA,200000,200000,0
1012881,5,NA,200000,200000,0
1012881,6,37,200000,210000,10000
1012881,7,29,210000,220000,10000
1012881,8,NA,220000,220000,0
1012881,9,50,220000,243000,23000
1012881,10,40,243000,266000,23000
1012881,11,60,266000,299000,33000
1012881,12,25,299000,311000,12000
1012881,13,NA,311000,311000,0
1012881,14,NA,311000,311000,0
1012881,15,NA,311000,311000,0
1012881,16,NA,311000,311000,0
1012881,17,NA,311000,311000,0
1012881,18,44,311000,322000,11000
1012881,19,NA,322000,322000,0
1012881,20,NA,322000,322000,0
1012881,21,33,322000,322000,0
1012881,22,19,322000,307000,-15000
1012881,23,26,307000,289000,-18000
1012881,24,22,289000,269000,-20000
1013093,1,NA,297000,297000,0
1013093,2,NA,297000,297000,0
1013093,3,NA,297000,297000,0
1013093,4,NA,297000,297000,0
1013093,5,24,297000,289000,-8000
1013093,6,8,289000,264000,-25000
1013093,7,NA,264000,264000,0
1013093,8,NA,264000,264000,0
1013093,9,NA,264000,264000,0
1013093,10,NA,264000,264000,0
1013093,11,NA,264000,264000,0
1013093,12,NA,264000,264000,0
1013093,13,NA,264000,264000,0
1013093,14,NA,264000,264000,0
1013093,15,NA,264000,264000,0
1013093,16,NA,264000,264000,0
1013093,17,29,264000,246000,-18000
1013093,18,26,246000,234000,-12000
1013093,19,0,234000,208000,-26000
1013093,20,NA,208000,208000,0
1013093,21,NA,208000,208000,0
1013093,22,48,208000,209000,1000
1013093,23,46,209000,228000,19000
1013093,24,NA,228000,228000,0
1013128,1,99,735000,746000,11000
1013128,2,104,746000,767000,21000
1013128,3,71,767000,767000,0
1013128,4,95,767000,770000,3000
1013128,5,96,770000,775000,5000
1013128,6,70,775000,763000,-12000
1013128,7,116,763000,773000,10000
1013128,8,161,773000,832000,59000
1013128,9,153,832000,907000,75000
1013128,10,106,907000,953000,46000
1013128,11,101,953000,972000,19000
1013128,12,NA,972000,972000,0
1013128,13,83,972000,954000,-18000
1013128,14,108,954000,937000,-17000
1013128,15,145,937000,946000,9000
1013128,16,128,946000,967000,21000
1013128,17,126,967000,990000,23000
1013128,18,126,990000,1012000,22000
1013128,19,89,1012000,1002000,-10000
1013128,20,142,1002000,1008000,6000
1013128,21,132,1008000,1020000,12000
1013128,22,88,1020000,1003000,-17000
1013128,23,107,1003000,984000,-19000
1013128,24,142,984000,987000,3000
1013133,1,58,411000,419000,8000
1013133,2,76,419000,445000,26000
1013133,3,66,445000,473000,28000
1013133,4,66,473000,497000,24000
1013133,5,91,497000,535000,38000
1013133,6,64,535000,558000,23000
1013133,7,58,558000,563000,5000
1013133,8,48,563000,552000,-11000
1013133,9,65,552000,543000,-9000
1013133,10,44,543000,520000,-23000
1013133,11,50,520000,499000,-21000
1013133,12,NA,499000,499000,0
1013133,13,94,499000,512000,13000
1013133,14,60,512000,525000,13000
1013133,15,72,525000,539000,14000
1013133,16,85,539000,565000,26000
1013133,17,66,565000,579000,14000
1013133,18,45,579000,568000,-11000
1013133,19,95,568000,580000,12000
1013133,20,110,580000,615000,35000
1013133,21,33,615000,609000,-6000
1013133,22,NA,609000,609000,0
1013133,23,67,609000,601000,-8000
1013133,24,22,601000,559000,-42000
1013138,1,NA,200000,200000,0
1013138,2,NA,200000,200000,0
1013138,3,NA,200000,200000,0
1013138,4,NA,200000,200000,0
1013138,5,NA,200000,200000,0
1013138,6,NA,200000,200000,0
1013138,7,9,200000,200000,0
1013138,8,21,200000,200000,0
1013138,9,25,200000,200000,0
1013138,10,NA,200000,200000,0
1013138,11,NA,200000,200000,0
1013138,12,NA,200000,200000,0
1013138,13,NA,200000,200000,0
1013138,14,NA,200000,200000,0
1013138,15,NA,200000,200000,0
1013138,16,NA,200000,200000,0
1013138,17,NA,200000,200000,0
1013138,18,NA,200000,200000,0
1013138,19,NA,200000,200000,0
1013138,20,NA,200000,200000,0
1013138,21,NA,200000,200000,0
1013138,22,NA,200000,200000,0
1013138,23,NA,200000,200000,0
1013138,24,NA,200000,200000,0
1013153,1,NA,423000,423000,0
1013153,2,1,423000,387000,-36000
1013153,3,NA,387000,387000,0
1013153,4,NA,387000,387000,0
1013153,5,NA,387000,387000,0
1013153,6,NA,387000,387000,0
1013153,7,NA,387000,387000,0
1013153,8,NA,387000,387000,0
1013153,9,100,387000,400000,13000
1013153,10,77,400000,431000,31000
1013153,11,0,431000,417000,-14000
1013153,12,NA,417000,417000,0
1013153,13,NA,417000,417000,0
1013153,14,NA,417000,417000,0
1013153,15,NA,417000,417000,0
1013153,16,NA,417000,417000,0
1013153,17,NA,417000,417000,0
1013153,18,NA,417000,417000,0
1013153,19,NA,417000,417000,0
1013153,20,NA,417000,417000,0
1013153,21,NA,417000,417000,0
1013153,22,NA,417000,417000,0
1013153,23,NA,417000,417000,0
1013153,24,40,417000,399000,-18000
1013165,1,NA,200000,200000,0
1013165,2,NA,200000,200000,0
1013165,3,NA,200000,200000,0
1013165,4,NA,200000,200000,0
1013165,5,NA,200000,200000,0
1013165,6,NA,200000,200000,0
1013165,7,NA,200000,200000,0
1013165,8,NA,200000,200000,0
1013165,9,NA,200000,200000,0
1013165,10,NA,200000,200000,0
1013165,11,NA,200000,200000,0
1013165,12,NA,200000,200000,0
1013165,13,NA,200000,200000,0
1013165,14,NA,200000,200000,0
1013165,15,NA,200000,200000,0
1013165,16,NA,200000,200000,0
1013165,17,NA,200000,200000,0
1013165,18,NA,200000,200000,0
1013165,19,NA,200000,200000,0
1013165,20,NA,200000,200000,0
1013165,21,NA,200000,200000,0
1013165,22,NA,200000,200000,0
1013165,23,NA,200000,200000,0
1013165,24,NA,200000,200000,0
1013197,1,NA,200000,200000,0
1013197,2,NA,200000,200000,0
1013197,3,NA,200000,200000,0
1013197,4,NA,200000,200000,0
1013197,5,NA,200000,200000,0
1013197,6,NA,200000,200000,0
1013197,7,NA,200000,200000,0
1013197,8,NA,200000,200000,0
1013197,9,NA,200000,200000,0
1013197,10,NA,200000,200000,0
1013197,11,NA,200000,200000,0
1013197,12,NA,200000,200000,0
1013197,13,NA,200000,200000,0
1013197,14,NA,200000,200000,0
1013197,15,NA,200000,200000,0
1013197,16,NA,200000,200000,0
1013197,17,39,200000,211000,11000
1013197,18,36,211000,226000,15000
1013197,19,74,226000,270000,44000
1013197,20,69,270000,323000,53000
1013197,21,40,323000,356000,33000
1013197,22,NA,356000,356000,0
1013197,23,NA,356000,356000,0
1013197,24,52,356000,379000,23000
1013201,1,74,283000,313000,30000
1013201,2,62,313000,355000,42000
1013201,3,41,355000,381000,26000
1013201,4,57,381000,405000,24000
1013201,5,9,405000,389000,-16000
1013201,6,48,389000,376000,-13000
1013201,7,NA,376000,376000,0
1013201,8,14,376000,345000,-31000
1013201,9,35,345000,322000,-23000
1013201,10,59,322000,324000,2000
1013201,11,51,324000,338000,14000
1013201,12,55,338000,357000,19000
1013201,13,58,357000,383000,26000
1013201,14,NA,383000,383000,0
1013201,15,23,383000,382000,-1000
1013201,16,38,382000,375000,-7000
1013201,17,38,375000,363000,-12000
1013201,18,38,363000,351000,-12000
1013201,19,NA,351000,351000,0
1013201,20,50,351000,350000,-1000
1013201,21,31,350000,344000,-6000
1013201,22,69,344000,361000,17000
1013201,23,35,361000,366000,5000
1013201,24,35,366000,362000,-4000
1013220,1,NA,550000,550000,0
1013220,2,NA,550000,550000,0
1013220,3,40,550000,531000,-19000
1013220,4,21,531000,488000,-43000
1013220,5,NA,488000,488000,0
1013220,6,NA,488000,488000,0
1013220,7,66,488000,466000,-22000
1013220,8,86,466000,476000,10000
1013220,9,44,476000,477000,1000
1013220,10,92,477000,506000,29000
1013220,11,67,506000,531000,25000
1013220,12,NA,531000,531000,0
1013220,13,65,531000,544000,13000
1013220,14,59,544000,550000,6000
1013220,15,NA,550000,550000,0
1013220,16,NA,550000,550000,0
1013220,17,NA,550000,550000,0
1013220,18,25,550000,522000,-28000
1013220,19,NA,522000,522000,0
1013220,20,NA,522000,522000,0
1013220,21,NA,522000,522000,0
1013220,22,NA,522000,522000,0
1013220,23,NA,522000,522000,0
1013220,24,NA,522000,522000,0
1013224,1,85,614000,625000,11000
1013224,2,72,625000,632000,7000
1013224,3,24,632000,601000,-31000
1013224,4,NA,601000,601000,0
1013224,5,NA,601000,601000,0
1013224,6,NA,601000,601000,0
1013224,7,NA,601000,601000,0
1013224,8,NA,601000,601000,0
1013224,9,NA,601000,601000,0
1013224,10,NA,601000,601000,0
1013224,11,NA,601000,601000,0
1013224,12,NA,601000,601000,0
1013224,13,NA,601000,601000,0
1013224,14,NA,601000,601000,0
1013224,15,NA,601000,601000,0
1013224,16,NA,601000,601000,0
1013224,17,NA,601000,601000,0
1013224,18,NA,601000,601000,0
1013224,19,NA,601000,601000,0
1013224,20,NA,601000,601000,0
1013224,21,NA,601000,601000,0
1013224,22,NA,601000,601000,0
1013224,23,NA,601000,601000,0
1013224,24,NA,601000,601000,0
1013230,1,56,431000,436000,5000
1013230,2,84,436000,464000,28000
1013230,3,71,464000,495000,31000
1013230,4,44,495000,504000,9000
1013230,5,50,504000,502000,-2000
1013230,6,19,502000,470000,-32000
1013230,7,62,470000,451000,-19000
1013230,8,69,451000,452000,1000
1013230,9,27,452000,436000,-16000
1013230,10,NA,436000,436000,0
1013230,11,NA,436000,436000,0
1013230,12,NA,436000,436000,0
1013230,13,NA,436000,436000,0
1013230,14,NA,436000,436000,0
1013230,15,81,436000,449000,13000
1013230,16,64,449000,468000,19000
1013230,17,29,468000,460000,-8000
1013230,18,26,460000,433000,-27000
1013230,19,76,433000,434000,1000
1013230,20,55,434000,435000,1000
1013230,21,39,435000,428000,-7000
1013230,22,66,428000,437000,9000
1013230,23,57,437000,447000,10000
1013230,24,65,447000,458000,11000
1013233,1,NA,396000,396000,0
1013233,2,NA,396000,396000,0
1013233,3,NA,396000,396000,0
1013233,4,13,396000,370000,-26000
1013233,5,NA,370000,370000,0
1013233,6,NA,370000,370000,0
1013233,7,NA,370000,370000,0
1013233,8,NA,370000,370000,0
1013233,9,NA,370000,370000,0
1013233,10,NA,370000,370000,0
1013233,11,NA,370000,370000,0
1013233,12,NA,370000,370000,0
1013233,13,NA,370000,370000,0
1013233,14,NA,370000,370000,0
1013233,15,NA,370000,370000,0
1013233,16,NA,370000,370000,0
1013233,17,NA,370000,370000,0
1013233,18,NA,370000,370000,0
1013233,19,NA,370000,370000,0
1013233,20,NA,370000,370000,0
1013233,21,NA,370000,370000,0
1013233,22,NA,370000,370000,0
1013233,23,NA,370000,370000,0
1013233,24,NA,370000,370000,0
1013256,1,NA,200000,200000,0
1013256,2,NA,200000,200000,0
1013256,3,NA,200000,200000,0
1013256,4,NA,200000,200000,0
1013256,5,NA,200000,200000,0
1013256,6,NA,200000,200000,0
1013256,7,NA,200000,200000,0
1013256,8,NA,200000,200000,0
1013256,9,NA,200000,200000,0
1013256,10,NA,200000,200000,0
1013256,11,NA,200000,200000,0
1013256,12,NA,200000,200000,0
1013256,13,NA,200000,200000,0
1013256,14,NA,200000,200000,0
1013256,15,NA,200000,200000,0
1013256,16,NA,200000,200000,0
1013256,17,NA,200000,200000,0
1013256,18,NA,200000,200000,0
1013256,19,NA,200000,200000,0
1013256,20,NA,200000,200000,0
1013256,21,NA,200000,200000,0
1013256,22,NA,200000,200000,0
1013256,23,NA,200000,200000,0
1013256,24,NA,200000,200000,0
1013260,1,NA,304000,304000,0
1013260,2,NA,304000,304000,0
1013260,3,NA,304000,304000,0
1013260,4,NA,304000,304000,0
1013260,5,NA,304000,304000,0
1013260,6,NA,304000,304000,0
1013260,7,NA,304000,304000,0
1013260,8,NA,304000,304000,0
1013260,9,NA,304000,304000,0
1013260,10,NA,304000,304000,0
1013260,11,NA,304000,304000,0
1013260,12,NA,304000,304000,0
1013260,13,NA,304000,304000,0
1013260,14,NA,304000,304000,0
1013260,15,NA,304000,304000,0
1013260,16,NA,304000,304000,0
1013260,17,NA,304000,304000,0
1013260,18,NA,304000,304000,0
1013260,19,NA,304000,304000,0
1013260,20,NA,304000,304000,0
1013260,21,NA,304000,304000,0
1013260,22,NA,304000,304000,0
1013260,23,NA,304000,304000,0
1013260,24,NA,304000,304000,0
1013268,1,43,388000,387000,-1000
1013268,2,NA,387000,387000,0
1013268,3,NA,387000,387000,0
1013268,4,NA,387000,387000,0
1013268,5,NA,387000,387000,0
1013268,6,NA,387000,387000,0
1013268,7,56,387000,393000,6000
1013268,8,35,393000,389000,-4000
1013268,9,70,389000,404000,15000
1013268,10,46,404000,411000,7000
1013268,11,56,411000,421000,10000
1013268,12,51,421000,427000,6000
1013268,13,NA,427000,427000,0
1013268,14,50,427000,433000,6000
1013268,15,NA,433000,433000,0
1013268,16,NA,433000,433000,0
1013268,17,NA,433000,433000,0
1013268,18,NA,433000,433000,0
1013268,19,NA,433000,433000,0
1013268,20,NA,433000,433000,0
1013268,21,NA,433000,433000,0
1013268,22,NA,433000,433000,0
1013268,23,NA,433000,433000,0
1013268,24,92,433000,459000,26000
1013278,1,36,280000,283000,3000
1013278,2,12,283000,270000,-13000
1013278,3,NA,270000,270000,0
1013278,4,12,270000,246000,-24000
1013278,5,NA,246000,246000,0
1013278,6,NA,246000,246000,0
1013278,7,NA,246000,246000,0
1013278,8,NA,246000,246000,0
1013278,9,19,246000,224000,-22000
1013278,10,NA,224000,224000,0
1013278,11,NA,224000,224000,0
1013278,12,NA,224000,224000,0
1013278,13,24,224000,209000,-15000
1013278,14,NA,209000,209000,0
1013278,15,NA,209000,209000,0
1013278,16,NA,209000,209000,0
1013278,17,NA,209000,209000,0
1013278,18,NA,209000,209000,0
1013278,19,NA,209000,209000,0
1013278,20,NA,209000,209000,0
1013278,21,NA,209000,209000,0
1013278,22,NA,209000,209000,0
1013278,23,NA,209000,209000,0
1013278,24,NA,209000,209000,0
1013315,1,NA,200000,200000,0
1013315,2,NA,200000,200000,0
1013315,3,NA,200000,200000,0
1013315,4,NA,200000,200000,0
1013315,5,NA,200000,200000,0
1013315,6,NA,200000,200000,0
1013315,7,NA,200000,200000,0
1013315,8,NA,200000,200000,0
1013315,9,NA,200000,200000,0
1013315,10,NA,200000,200000,0
1013315,11,NA,200000,200000,0
1013315,12,NA,200000,200000,0
1013315,13,NA,200000,200000,0
1013315,14,NA,200000,200000,0
1013315,15,NA,200000,200000,0
1013315,16,NA,200000,200000,0
1013315,17,NA,200000,200000,0
1013315,18,NA,200000,200000,0
1013315,19,NA,200000,200000,0
1013315,20,NA,200000,200000,0
1013315,21,NA,200000,200000,0
1013315,22,NA,200000,200000,0
1013315,23,NA,200000,200000,0
1013315,24,NA,200000,200000,0
1013409,1,NA,638000,638000,0
1013409,2,NA,638000,638000,0
1013409,3,97,638000,653000,15000
1013409,4,37,653000,636000,-17000
1013409,5,40,636000,600000,-36000
1013409,6,67,600000,574000,-26000
1013409,7,64,574000,556000,-18000
1013409,8,67,556000,546000,-10000
1013409,9,33,546000,523000,-23000
1013409,10,24,523000,483000,-40000
1013409,11,11,483000,425000,-58000
1013409,12,NA,425000,425000,0
1013409,13,36,425000,378000,-47000
1013409,14,NA,378000,378000,0
1013409,15,37,378000,347000,-31000
1013409,16,NA,347000,347000,0
1013409,17,79,347000,358000,11000
1013409,18,77,358000,395000,37000
1013409,19,44,395000,419000,24000
1013409,20,41,419000,428000,9000
1013409,21,67,428000,443000,15000
1013409,22,34,443000,434000,-9000
1013409,23,NA,434000,434000,0
1013409,24,NA,434000,434000,0
1013462,1,NA,486000,486000,0
1013462,2,24,486000,462000,-24000
1013462,3,NA,462000,462000,0
1013462,4,NA,462000,462000,0
1013462,5,NA,462000,462000,0
1013462,6,NA,462000,462000,0
1013462,7,45,462000,437000,-25000
1013462,8,NA,437000,437000,0
1013462,9,NA,437000,437000,0
1013462,10,NA,437000,437000,0
1013462,11,NA,437000,437000,0
1013462,12,NA,437000,437000,0
1013462,13,NA,437000,437000,0
1013462,14,NA,437000,437000,0
1013462,15,NA,437000,437000,0
1013462,16,5,437000,389000,-48000
1013462,17,NA,389000,389000,0
1013462,18,50,389000,362000,-27000
1013462,19,NA,362000,362000,0
1013462,20,NA,362000,362000,0
1013462,21,55,362000,356000,-6000
1013462,22,NA,356000,356000,0
1013462,23,NA,356000,356000,0
1013462,24,NA,356000,356000,0
1013511,1,NA,266000,266000,0
1013511,2,NA,266000,266000,0
1013511,3,80,266000,301000,35000
1013511,4,13,301000,311000,10000
1013511,5,50,311000,326000,15000
1013511,6,46,326000,341000,15000
1013511,7,44,341000,350000,9000
1013511,8,39,350000,351000,1000
1013511,9,NA,351000,351000,0
1013511,10,81,351000,381000,30000
1013511,11,39,381000,395000,14000
1013511,12,67,395000,416000,21000
1013511,13,69,416000,443000,27000
1013511,14,NA,443000,443000,0
1013511,15,28,443000,442000,-1000
1013511,16,NA,442000,442000,0
1013511,17,63,442000,446000,4000
1013511,18,65,446000,456000,10000
1013511,19,60,456000,465000,9000
1013511,20,28,465000,451000,-14000
1013511,21,NA,451000,451000,0
1013511,22,NA,451000,451000,0
1013511,23,NA,451000,451000,0
1013511,24,NA,451000,451000,0
1013532,1,NA,292000,292000,0
1013532,2,NA,292000,292000,0
1013532,3,NA,292000,292000,0
1013532,4,NA,292000,292000,0
1013532,5,NA,292000,292000,0
1013532,6,NA,292000,292000,0
1013532,7,NA,292000,292000,0
1013532,8,NA,292000,292000,0
1013532,9,NA,292000,292000,0
1013532,10,NA,292000,292000,0
1013532,11,NA,292000,292000,0
1013532,12,NA,292000,292000,0
1013532,13,NA,292000,292000,0
1013532,14,NA,292000,292000,0
1013532,15,NA,292000,292000,0
1013532,16,NA,292000,292000,0
1013532,17,NA,292000,292000,0
1013532,18,NA,292000,292000,0
1013532,19,NA,292000,292000,0
1013532,20,NA,292000,292000,0
1013532,21,NA,292000,292000,0
1013532,22,NA,292000,292000,0
1013532,23,NA,292000,292000,0
1013532,24,NA,292000,292000,0
1013611,1,NA,200000,200000,0
1013611,2,NA,200000,200000,0
1013611,3,NA,200000,200000,0
1013611,4,NA,200000,200000,0
1013611,5,43,200000,214000,14000
1013611,6,43,214000,237000,23000
1013611,7,29,237000,253000,16000
1013611,8,NA,253000,253000,0
1013611,9,NA,253000,253000,0
1013611,10,NA,253000,253000,0
1013611,11,15,253000,251000,-2000
1013611,12,NA,251000,251000,0
1013611,13,40,251000,255000,4000
1013611,14,68,255000,284000,29000
1013611,15,19,284000,290000,6000
1013611,16,NA,290000,290000,0
1013611,17,NA,290000,290000,0
1013611,18,47,290000,304000,14000
1013611,19,63,304000,331000,27000
1013611,20,53,331000,356000,25000
1013611,21,51,356000,375000,19000
1013611,22,72,375000,407000,32000
1013611,23,22,407000,406000,-1000
1013611,24,36,406000,393000,-13000
1013973,1,38,470000,458000,-12000
1013973,2,65,458000,458000,0
1013973,3,25,458000,438000,-20000
1013973,4,NA,438000,438000,0
1013973,5,NA,438000,438000,0
1013973,6,NA,438000,438000,0
1013973,7,NA,438000,438000,0
1013973,8,NA,438000,438000,0
1013973,9,59,438000,430000,-8000
1013973,10,43,430000,420000,-10000
1013973,11,45,420000,412000,-8000
1013973,12,25,412000,390000,-22000
1013973,13,50,390000,381000,-9000
1013973,14,66,381000,392000,11000
1013973,15,NA,392000,392000,0
1013973,16,54,392000,404000,12000
1013973,17,60,404000,422000,18000
1013973,18,NA,422000,422000,0
1013973,19,NA,422000,422000,0
1013973,20,63,422000,443000,21000
1013973,21,50,443000,453000,10000
1013973,22,44,453000,449000,-4000
1013973,23,65,449000,454000,5000
1013973,24,57,454000,456000,2000
1013974,1,NA,304000,304000,0
1013974,2,NA,304000,304000,0
1013974,3,NA,304000,304000,0
1013974,4,NA,304000,304000,0
1013974,5,NA,304000,304000,0
1013974,6,NA,304000,304000,0
1013974,7,NA,304000,304000,0
1013974,8,NA,304000,304000,0
1013974,9,NA,304000,304000,0
1013974,10,NA,304000,304000,0
1013974,11,NA,304000,304000,0
1013974,12,NA,304000,304000,0
1013974,13,NA,304000,304000,0
1013974,14,NA,304000,304000,0
1013974,15,NA,304000,304000,0
1013974,16,NA,304000,304000,0
1013974,17,NA,304000,304000,0
1013974,18,NA,304000,304000,0
1013974,19,NA,304000,304000,0
1013974,20,51,304000,314000,10000
1013974,21,57,314000,336000,22000
1013974,22,46,336000,354000,18000
1013974,23,42,354000,365000,11000
1013974,24,60,365000,380000,15000
1013978,1,NA,295000,295000,0
1013978,2,NA,295000,295000,0
1013978,3,NA,295000,295000,0
1013978,4,NA,295000,295000,0
1013978,5,NA,295000,295000,0
1013978,6,NA,295000,295000,0
1013978,7,NA,295000,295000,0
1013978,8,NA,295000,295000,0
1013978,9,NA,295000,295000,0
1013978,10,NA,295000,295000,0
1013978,11,8,295000,275000,-20000
1013978,12,NA,275000,275000,0
1013978,13,NA,275000,275000,0
1013978,14,NA,275000,275000,0
1013978,15,NA,275000,275000,0
1013978,16,NA,275000,275000,0
1013978,17,28,275000,258000,-17000
1013978,18,NA,258000,258000,0
1013978,19,NA,258000,258000,0
1013978,20,NA,258000,258000,0
1013978,21,NA,258000,258000,0
1013978,22,NA,258000,258000,0
1013978,23,NA,258000,258000,0
1013978,24,NA,258000,258000,0
1014026,1,NA,209000,209000,0
1014026,2,NA,209000,209000,0
1014026,3,NA,209000,209000,0
1014026,4,NA,209000,209000,0
1014026,5,NA,209000,209000,0
1014026,6,NA,209000,209000,0
1014026,7,NA,209000,209000,0
1014026,8,NA,209000,209000,0
1014026,9,NA,209000,209000,0
1014026,10,NA,209000,209000,0
1014026,11,NA,209000,209000,0
1014026,12,NA,209000,209000,0
1014026,13,NA,209000,209000,0
1014026,14,57,209000,233000,24000
1014026,15,27,233000,249000,16000
1014026,16,NA,249000,249000,0
1014026,17,25,249000,256000,7000
1014026,18,NA,256000,256000,0
1014026,19,5,256000,242000,-14000
1014026,20,63,242000,254000,12000
1014026,21,NA,254000,254000,0
1014026,22,NA,254000,254000,0
1014026,23,NA,254000,254000,0
1014026,24,17,254000,250000,-4000
1014038,1,NA,403000,403000,0
1014038,2,NA,403000,403000,0
1014038,3,NA,403000,403000,0
1014038,4,NA,403000,403000,0
1014038,5,NA,403000,403000,0
1014038,6,NA,403000,403000,0
1014038,7,54,403000,407000,4000
1014038,8,23,407000,392000,-15000
1014038,9,26,392000,368000,-24000
1014038,10,NA,368000,368000,0
1014038,11,47,368000,355000,-13000
1014038,12,55,355000,356000,1000
1014038,13,67,356000,375000,19000
1014038,14,94,375000,428000,53000
1014038,15,NA,428000,428000,0
1014038,16,52,428000,462000,34000
1014038,17,51,462000,478000,16000
1014038,18,62,478000,489000,11000
1014038,19,50,489000,486000,-3000
1014038,20,69,486000,489000,3000
1014038,21,69,489000,500000,11000
1014038,22,47,500000,498000,-2000
1014038,23,47,498000,488000,-10000
1014038,24,31,488000,461000,-27000
1015294,1,NA,200000,200000,0
1015294,2,NA,200000,200000,0
1015294,3,NA,200000,200000,0
1015294,4,NA,200000,200000,0
1015294,5,NA,200000,200000,0
1015294,6,NA,200000,200000,0
1015294,7,NA,200000,200000,0
1015294,8,NA,200000,200000,0
1015294,9,NA,200000,200000,0
1015294,10,NA,200000,200000,0
1015294,11,NA,200000,200000,0
1015294,12,NA,200000,200000,0
1015294,13,NA,200000,200000,0
1015294,14,NA,200000,200000,0
1015294,15,NA,200000,200000,0
1015294,16,NA,200000,200000,0
1015294,17,NA,200000,200000,0
1015294,18,NA,200000,200000,0
1015294,19,NA,200000,200000,0
1015294,20,NA,200000,200000,0
1015294,21,NA,200000,200000,0
1015294,22,NA,200000,200000,0
1015294,23,NA,200000,200000,0
1015294,24,NA,200000,200000,0
1015323,1,NA,214000,214000,0
1015323,2,NA,214000,214000,0
1015323,3,NA,214000,214000,0
1015323,4,NA,214000,214000,0
1015323,5,NA,214000,214000,0
1015323,6,NA,214000,214000,0
1015323,7,NA,214000,214000,0
1015323,8,NA,214000,214000,0
1015323,9,NA,214000,214000,0
1015323,10,NA,214000,214000,0
1015323,11,NA,214000,214000,0
1015323,12,NA,214000,214000,0
1015323,13,NA,214000,214000,0
1015323,14,NA,214000,214000,0
1015323,15,NA,214000,214000,0
1015323,16,NA,214000,214000,0
1015323,17,NA,214000,214000,0
1015323,18,NA,214000,214000,0
1015323,19,NA,214000,214000,0
1015323,20,NA,214000,214000,0
1015323,21,NA,214000,214000,0
1015323,22,NA,214000,214000,0
1015323,23,NA,214000,214000,0
1015323,24,NA,214000,214000,0
1015329,1,NA,216000,216000,0
1015329,2,NA,216000,216000,0
1015329,3,NA,216000,216000,0
1015329,4,NA,216000,216000,0
1015329,5,NA,216000,216000,0
1015329,6,NA,216000,216000,0
1015329,7,NA,216000,216000,0
1015329,8,NA,216000,216000,0
1015329,9,NA,216000,216000,0
1015329,10,NA,216000,216000,0
1015329,11,NA,216000,216000,0
1015329,12,NA,216000,216000,0
1015329,13,NA,216000,216000,0
1015329,14,NA,216000,216000,0
1015329,15,NA,216000,216000,0
1015329,16,NA,216000,216000,0
1015329,17,NA,216000,216000,0
1015329,18,NA,216000,216000,0
1015329,19,NA,216000,216000,0
1015329,20,NA,216000,216000,0
1015329,21,NA,216000,216000,0
1015329,22,NA,216000,216000,0
1015329,23,NA,216000,216000,0
1015329,24,NA,216000,216000,0
1015330,1,NA,200000,200000,0
1015330,2,NA,200000,200000,0
1015330,3,NA,200000,200000,0
1015330,4,NA,200000,200000,0
1015330,5,NA,200000,200000,0
1015330,6,NA,200000,200000,0
1015330,7,NA,200000,200000,0
1015330,8,NA,200000,200000,0
1015330,9,NA,200000,200000,0
1015330,10,NA,200000,200000,0
1015330,11,NA,200000,200000,0
1015330,12,NA,200000,200000,0
1015330,13,NA,200000,200000,0
1015330,14,NA,200000,200000,0
1015330,15,NA,200000,200000,0
1015330,16,NA,200000,200000,0
1015330,17,NA,200000,200000,0
1015330,18,NA,200000,200000,0
1015330,19,NA,200000,200000,0
1015330,20,NA,200000,200000,0
1015330,21,NA,200000,200000,0
1015330,22,NA,200000,200000,0
1015330,23,NA,200000,200000,0
1015330,24,NA,200000,200000,0
1015332,1,NA,200000,200000,0
1015332,2,NA,200000,200000,0
1015332,3,NA,200000,200000,0
1015332,4,NA,200000,200000,0
1015332,5,NA,200000,200000,0
1015332,6,NA,200000,200000,0
1015332,7,NA,200000,200000,0
1015332,8,NA,200000,200000,0
1015332,9,NA,200000,200000,0
1015332,10,NA,200000,200000,0
1015332,11,NA,200000,200000,0
1015332,12,54,200000,221000,21000
1015332,13,54,221000,256000,35000
1015332,14,NA,256000,256000,0
1015332,15,46,256000,291000,35000
1015332,16,4,291000,291000,0
1015332,17,NA,291000,291000,0
1015332,18,NA,291000,291000,0
1015332,19,NA,291000,291000,0
1015332,20,NA,291000,291000,0
1015332,21,NA,291000,291000,0
1015332,22,NA,291000,291000,0
1015332,23,NA,291000,291000,0
1015332,24,NA,291000,291000,0
1015369,1,NA,200000,200000,0
1015369,2,NA,200000,200000,0
1015369,3,NA,200000,200000,0
1015369,4,NA,200000,200000,0
1015369,5,NA,200000,200000,0
1015369,6,NA,200000,200000,0
1015369,7,NA,200000,200000,0
1015369,8,NA,200000,200000,0
1015369,9,NA,200000,200000,0
1015369,10,NA,200000,200000,0
1015369,11,NA,200000,200000,0
1015369,12,NA,200000,200000,0
1015369,13,NA,200000,200000,0
1015369,14,NA,200000,200000,0
1015369,15,NA,200000,200000,0
1015369,16,NA,200000,200000,0
1015369,17,NA,200000,200000,0
1015369,18,NA,200000,200000,0
1015369,19,NA,200000,200000,0
1015369,20,NA,200000,200000,0
1015369,21,NA,200000,200000,0
1015369,22,NA,200000,200000,0
1015369,23,NA,200000,200000,0
1015369,24,NA,200000,200000,0
1015370,1,50,268000,282000,14000
1015370,2,48,282000,304000,22000
1015370,3,68,304000,342000,38000
1015370,4,66,342000,384000,42000
1015370,5,50,384000,412000,28000
1015370,6,60,412000,436000,24000
1015370,7,52,436000,448000,12000
1015370,8,64,448000,461000,13000
1015370,9,46,461000,461000,0
1015370,10,45,461000,453000,-8000
1015370,11,59,453000,452000,-1000
1015370,12,48,452000,446000,-6000
1015370,13,27,446000,424000,-22000
1015370,14,NA,424000,424000,0
1015370,15,56,424000,417000,-7000
1015370,16,56,417000,418000,1000
1015370,17,22,418000,399000,-19000
1015370,18,55,399000,393000,-6000
1015370,19,NA,393000,393000,0
1015370,20,44,393000,390000,-3000
1015370,21,66,390000,401000,11000
1015370,22,68,401000,422000,21000
1015370,23,49,422000,437000,15000
1015370,24,53,437000,444000,7000
1015457,1,NA,200000,200000,0
1015457,2,NA,200000,200000,0
1015457,3,NA,200000,200000,0
1015457,4,NA,200000,200000,0
1015457,5,NA,200000,200000,0
1015457,6,NA,200000,200000,0
1015457,7,NA,200000,200000,0
1015457,8,NA,200000,200000,0
1015457,9,NA,200000,200000,0
1015457,10,NA,200000,200000,0
1015457,11,NA,200000,200000,0
1015457,12,NA,200000,200000,0
1015457,13,NA,200000,200000,0
1015457,14,NA,200000,200000,0
1015457,15,NA,200000,200000,0
1015457,16,NA,200000,200000,0
1015457,17,NA,200000,200000,0
1015457,18,NA,200000,200000,0
1015457,19,NA,200000,200000,0
1015457,20,NA,200000,200000,0
1015457,21,NA,200000,200000,0
1015457,22,NA,200000,200000,0
1015457,23,NA,200000,200000,0
1015457,24,NA,200000,200000,0
1015473,1,NA,200000,200000,0
1015473,2,NA,200000,200000,0
1015473,3,NA,200000,200000,0
1015473,4,NA,200000,200000,0
1015473,5,NA,200000,200000,0
1015473,6,NA,200000,200000,0
1015473,7,NA,200000,200000,0
1015473,8,NA,200000,200000,0
1015473,9,NA,200000,200000,0
1015473,10,NA,200000,200000,0
1015473,11,NA,200000,200000,0
1015473,12,NA,200000,200000,0
1015473,13,NA,200000,200000,0
1015473,14,NA,200000,200000,0
1015473,15,NA,200000,200000,0
1015473,16,NA,200000,200000,0
1015473,17,NA,200000,200000,0
1015473,18,NA,200000,200000,0
1015473,19,NA,200000,200000,0
1015473,20,NA,200000,200000,0
1015473,21,NA,200000,200000,0
1015473,22,NA,200000,200000,0
1015473,23,NA,200000,200000,0
1015473,24,NA,200000,200000,0
1015507,1,70,555000,559000,4000
1015507,2,79,559000,573000,14000
1015507,3,79,573000,592000,19000
1015507,4,107,592000,630000,38000
1015507,5,66,630000,648000,18000
1015507,6,55,648000,644000,-4000
1015507,7,101,644000,656000,12000
1015507,8,125,656000,697000,41000
1015507,9,53,697000,699000,2000
1015507,10,107,699000,719000,20000
1015507,11,81,719000,729000,10000
1015507,12,NA,729000,729000,0
1015507,13,118,729000,752000,23000
1015507,14,75,752000,759000,7000
1015507,15,102,759000,773000,14000
1015507,16,93,773000,781000,8000
1015507,17,130,781000,811000,30000
1015507,18,105,811000,834000,23000
1015507,19,89,834000,842000,8000
1015507,20,125,842000,864000,22000
1015507,21,74,864000,856000,-8000
1015507,22,103,856000,848000,-8000
1015507,23,91,848000,836000,-12000
1015507,24,73,836000,807000,-29000
1015515,1,NA,200000,200000,0
1015515,2,NA,200000,200000,0
1015515,3,NA,200000,200000,0
1015515,4,NA,200000,200000,0
1015515,5,NA,200000,200000,0
1015515,6,NA,200000,200000,0
1015515,7,NA,200000,200000,0
1015515,8,NA,200000,200000,0
1015515,9,NA,200000,200000,0
1015515,10,NA,200000,200000,0
1015515,11,NA,200000,200000,0
1015515,12,NA,200000,200000,0
1015515,13,NA,200000,200000,0
1015515,14,NA,200000,200000,0
1015515,15,NA,200000,200000,0
1015515,16,NA,200000,200000,0
1015515,17,NA,200000,200000,0
1015515,18,NA,200000,200000,0
1015515,19,NA,200000,200000,0
1015515,20,NA,200000,200000,0
1015515,21,NA,200000,200000,0
1015515,22,NA,200000,200000,0
1015515,23,NA,200000,200000,0
1015515,24,NA,200000,200000,0
1015714,1,NA,200000,200000,0
1015714,2,NA,200000,200000,0
1015714,3,NA,200000,200000,0
1015714,4,NA,200000,200000,0
1015714,5,NA,200000,200000,0
1015714,6,NA,200000,200000,0
1015714,7,NA,200000,200000,0
1015714,8,NA,200000,200000,0
1015714,9,NA,200000,200000,0
1015714,10,NA,200000,200000,0
1015714,11,NA,200000,200000,0
1015714,12,NA,200000,200000,0
1015714,13,NA,200000,200000,0
1015714,14,NA,200000,200000,0
1015714,15,NA,200000,200000,0
1015714,16,NA,200000,200000,0
1015714,17,NA,200000,200000,0
1015714,18,NA,200000,200000,0
1015714,19,NA,200000,200000,0
1015714,20,NA,200000,200000,0
1015714,21,NA,200000,200000,0
1015714,22,NA,200000,200000,0
1015714,23,NA,200000,200000,0
1015714,24,NA,200000,200000,0
1015748,1,NA,306000,306000,0
1015748,2,NA,306000,306000,0
1015748,3,NA,306000,306000,0
1015748,4,NA,306000,306000,0
1015748,5,NA,306000,306000,0
1015748,6,NA,306000,306000,0
1015748,7,NA,306000,306000,0
1015748,8,NA,306000,306000,0
1015748,9,NA,306000,306000,0
1015748,10,NA,306000,306000,0
1015748,11,NA,306000,306000,0
1015748,12,NA,306000,306000,0
1015748,13,NA,306000,306000,0
1015748,14,NA,306000,306000,0
1015748,15,NA,306000,306000,0
1015748,16,NA,306000,306000,0
1015748,17,NA,306000,306000,0
1015748,18,NA,306000,306000,0
1015748,19,NA,306000,306000,0
1015748,20,NA,306000,306000,0
1015748,21,NA,306000,306000,0
1015748,22,NA,306000,306000,0
1015748,23,NA,306000,306000,0
1015748,24,NA,306000,306000,0
1015777,1,NA,200000,200000,0
1015777,2,NA,200000,200000,0
1015777,3,NA,200000,200000,0
1015777,4,NA,200000,200000,0
1015777,5,NA,200000,200000,0
1015777,6,54,200000,222000,22000
1015777,7,45,222000,251000,29000
1015777,8,24,251000,267000,16000
1015777,9,42,267000,283000,16000
1015777,10,32,283000,289000,6000
1015777,11,51,289000,302000,13000
1015777,12,39,302000,311000,9000
1015777,13,43,311000,322000,11000
1015777,14,2,322000,304000,-18000
1015777,15,NA,304000,304000,0
1015777,16,10,304000,273000,-31000
1015777,17,NA,273000,273000,0
1015777,18,64,273000,274000,1000
1015777,19,65,274000,298000,24000
1015777,20,49,298000,325000,27000
1015777,21,7,325000,323000,-2000
1015777,22,NA,323000,323000,0
1015777,23,NA,323000,323000,0
1015777,24,57,323000,332000,9000
1015781,1,80,259000,296000,37000
1015781,2,19,296000,312000,16000
1015781,3,54,312000,334000,22000
1015781,4,19,334000,332000,-2000
1015781,5,77,332000,355000,23000
1015781,6,33,355000,361000,6000
1015781,7,6,361000,340000,-21000
1015781,8,NA,340000,340000,0
1015781,9,NA,340000,340000,0
1015781,10,NA,340000,340000,0
1015781,11,NA,340000,340000,0
1015781,12,NA,340000,340000,0
1015781,13,NA,340000,340000,0
1015781,14,NA,340000,340000,0
1015781,15,NA,340000,340000,0
1015781,16,NA,340000,340000,0
1015781,17,NA,340000,340000,0
1015781,18,NA,340000,340000,0
1015781,19,NA,340000,340000,0
1015781,20,NA,340000,340000,0
1015781,21,NA,340000,340000,0
1015781,22,NA,340000,340000,0
1015781,23,NA,340000,340000,0
1015781,24,NA,340000,340000,0
1015810,1,89,503000,526000,23000
1015810,2,71,526000,550000,24000
1015810,3,70,550000,570000,20000
1015810,4,46,570000,566000,-4000
1015810,5,67,566000,562000,-4000
1015810,6,32,562000,533000,-29000
1015810,7,70,533000,519000,-14000
1015810,8,NA,519000,519000,0
1015810,9,49,519000,503000,-16000
1015810,10,96,503000,521000,18000
1015810,11,23,521000,506000,-15000
1015810,12,51,506000,492000,-14000
1015810,13,75,492000,494000,2000
1015810,14,NA,494000,494000,0
1015810,15,56,494000,494000,0
1015810,16,43,494000,483000,-11000
1015810,17,76,483000,492000,9000
1015810,18,62,492000,500000,8000
1015810,19,66,500000,508000,8000
1015810,20,53,508000,509000,1000
1015810,21,82,509000,525000,16000
1015810,22,69,525000,538000,13000
1015810,23,44,538000,531000,-7000
1015810,24,96,531000,548000,17000
1015822,1,NA,279000,279000,0
1015822,2,NA,279000,279000,0
1015822,3,NA,279000,279000,0
1015822,4,NA,279000,279000,0
1015822,5,NA,279000,279000,0
1015822,6,NA,279000,279000,0
1015822,7,NA,279000,279000,0
1015822,8,NA,279000,279000,0
1015822,9,NA,279000,279000,0
1015822,10,NA,279000,279000,0
1015822,11,NA,279000,279000,0
1015822,12,NA,279000,279000,0
1015822,13,NA,279000,279000,0
1015822,14,NA,279000,279000,0
1015822,15,NA,279000,279000,0
1015822,16,NA,279000,279000,0
1015822,17,NA,279000,279000,0
1015822,18,NA,279000,279000,0
1015822,19,NA,279000,279000,0
1015822,20,NA,279000,279000,0
1015822,21,NA,279000,279000,0
1015822,22,NA,279000,279000,0
1015822,23,NA,279000,279000,0
1015822,24,NA,279000,279000,0
1015827,1,NA,423000,423000,0
1015827,2,NA,423000,423000,0
1015827,3,NA,423000,423000,0
1015827,4,NA,423000,423000,0
1015827,5,NA,423000,423000,0
1015827,6,NA,423000,423000,0
1015827,7,NA,423000,423000,0
1015827,8,NA,423000,423000,0
1015827,9,NA,423000,423000,0
1015827,10,NA,423000,423000,0
1015827,11,NA,423000,423000,0
1015827,12,NA,423000,423000,0
1015827,13,NA,423000,423000,0
1015827,14,NA,423000,423000,0
1015827,15,NA,423000,423000,0
1015827,16,NA,423000,423000,0
1015827,17,NA,423000,423000,0
1015827,18,NA,423000,423000,0
1015827,19,52,423000,424000,1000
1015827,20,31,424000,411000,-13000
1015827,21,50,411000,403000,-8000
1015827,22,39,403000,392000,-11000
1015827,23,30,392000,374000,-18000
1015827,24,63,374000,374000,0
1015830,1,NA,200000,200000,0
1015830,2,NA,200000,200000,0
1015830,3,NA,200000,200000,0
1015830,4,NA,200000,200000,0
1015830,5,NA,200000,200000,0
1015830,6,NA,200000,200000,0
1015830,7,NA,200000,200000,0
1015830,8,NA,200000,200000,0
1015830,9,NA,200000,200000,0
1015830,10,NA,200000,200000,0
1015830,11,NA,200000,200000,0
1015830,12,NA,200000,200000,0
1015830,13,NA,200000,200000,0
1015830,14,NA,200000,200000,0
1015830,15,NA,200000,200000,0
1015830,16,NA,200000,200000,0
1015830,17,NA,200000,200000,0
1015830,18,NA,200000,200000,0
1015830,19,NA,200000,200000,0
1015830,20,NA,200000,200000,0
1015830,21,NA,200000,200000,0
1015830,22,NA,200000,200000,0
1015830,23,NA,200000,200000,0
1015830,24,NA,200000,200000,0
1015862,1,NA,252000,252000,0
1015862,2,26,252000,249000,-3000
1015862,3,15,249000,237000,-12000
1015862,4,12,237000,218000,-19000
1015862,5,NA,218000,218000,0
1015862,6,NA,218000,218000,0
1015862,7,NA,218000,218000,0
1015862,8,NA,218000,218000,0
1015862,9,NA,218000,218000,0
1015862,10,NA,218000,218000,0
1015862,11,NA,218000,218000,0
1015862,12,NA,218000,218000,0
1015862,13,NA,218000,218000,0
1015862,14,NA,218000,218000,0
1015862,15,NA,218000,218000,0
1015862,16,NA,218000,218000,0
1015862,17,NA,218000,218000,0
1015862,18,NA,218000,218000,0
1015862,19,NA,218000,218000,0
1015862,20,NA,218000,218000,0
1015862,21,NA,218000,218000,0
1015862,22,NA,218000,218000,0
1015862,23,NA,218000,218000,0
1015862,24,NA,218000,218000,0
1015873,1,104,527000,559000,32000
1015873,2,34,559000,560000,1000
1015873,3,73,560000,565000,5000
1015873,4,66,565000,567000,2000
1015873,5,64,567000,565000,-2000
1015873,6,77,565000,570000,5000
1015873,7,54,570000,566000,-4000
1015873,8,63,566000,561000,-5000
1015873,9,77,561000,565000,4000
1015873,10,79,565000,576000,11000
1015873,11,83,576000,593000,17000
1015873,12,87,593000,616000,23000
1015873,13,72,616000,629000,13000
1015873,14,NA,629000,629000,0
1015873,15,57,629000,625000,-4000
1015873,16,51,625000,605000,-20000
1015873,17,103,605000,612000,7000
1015873,18,71,612000,615000,3000
1015873,19,27,615000,586000,-29000
1015873,20,57,586000,560000,-26000
1015873,21,75,560000,551000,-9000
1015873,22,87,551000,558000,7000
1015873,23,55,558000,557000,-1000
1015873,24,32,557000,534000,-23000
1015886,1,NA,200000,200000,0
1015886,2,NA,200000,200000,0
1015886,3,NA,200000,200000,0
1015886,4,NA,200000,200000,0
1015886,5,NA,200000,200000,0
1015886,6,NA,200000,200000,0
1015886,7,NA,200000,200000,0
1015886,8,NA,200000,200000,0
1015886,9,NA,200000,200000,0
1015886,10,NA,200000,200000,0
1015886,11,NA,200000,200000,0
1015886,12,NA,200000,200000,0
1015886,13,NA,200000,200000,0
1015886,14,NA,200000,200000,0
1015886,15,NA,200000,200000,0
1015886,16,NA,200000,200000,0
1015886,17,NA,200000,200000,0
1015886,18,NA,200000,200000,0
1015886,19,NA,200000,200000,0
1015886,20,NA,200000,200000,0
1015886,21,NA,200000,200000,0
1015886,22,NA,200000,200000,0
1015886,23,NA,200000,200000,0
1015886,24,NA,200000,200000,0
1015889,1,70,565000,569000,4000
1015889,2,87,569000,587000,18000
1015889,3,59,587000,593000,6000
1015889,4,99,593000,617000,24000
1015889,5,72,617000,632000,15000
1015889,6,98,632000,658000,26000
1015889,7,79,658000,673000,15000
1015889,8,100,673000,698000,25000
1015889,9,69,698000,701000,3000
1015889,10,47,701000,676000,-25000
1015889,11,NA,676000,676000,0
1015889,12,NA,676000,676000,0
1015889,13,NA,676000,676000,0
1015889,14,84,676000,664000,-12000
1015889,15,70,664000,649000,-15000
1015889,16,50,649000,621000,-28000
1015889,17,89,621000,617000,-4000
1015889,18,109,617000,642000,25000
1015889,19,76,642000,658000,16000
1015889,20,81,658000,671000,13000
1015889,21,45,671000,656000,-15000
1015889,22,40,656000,616000,-40000
1015889,23,73,616000,587000,-29000
1015889,24,96,587000,587000,0
1015895,1,NA,200000,200000,0
1015895,2,NA,200000,200000,0
1015895,3,NA,200000,200000,0
1015895,4,NA,200000,200000,0
1015895,5,NA,200000,200000,0
1015895,6,NA,200000,200000,0
1015895,7,NA,200000,200000,0
1015895,8,NA,200000,200000,0
1015895,9,NA,200000,200000,0
1015895,10,NA,200000,200000,0
1015895,11,NA,200000,200000,0
1015895,12,NA,200000,200000,0
1015895,13,NA,200000,200000,0
1015895,14,NA,200000,200000,0
1015895,15,NA,200000,200000,0
1015895,16,NA,200000,200000,0
1015895,17,NA,200000,200000,0
1015895,18,NA,200000,200000,0
1015895,19,NA,200000,200000,0
1015895,20,NA,200000,200000,0
1015895,21,NA,200000,200000,0
1015895,22,NA,200000,200000,0
1015895,23,NA,200000,200000,0
1015895,24,NA,200000,200000,0
1015929,1,NA,424000,424000,0
1015929,2,NA,424000,424000,0
1015929,3,NA,424000,424000,0
1015929,4,NA,424000,424000,0
1015929,5,NA,424000,424000,0
1015929,6,NA,424000,424000,0
1015929,7,NA,424000,424000,0
1015929,8,NA,424000,424000,0
1015929,9,NA,424000,424000,0
1015929,10,NA,424000,424000,0
1015929,11,NA,424000,424000,0
1015929,12,NA,424000,424000,0
1015929,13,NA,424000,424000,0
1015929,14,NA,424000,424000,0
1015929,15,NA,424000,424000,0
1015929,16,NA,424000,424000,0
1015929,17,NA,424000,424000,0
1015929,18,NA,424000,424000,0
1015929,19,NA,424000,424000,0
1015929,20,31,424000,410000,-14000
1015929,21,NA,410000,410000,0
1015929,22,NA,410000,410000,0
1015929,23,NA,410000,410000,0
1015929,24,NA,410000,410000,0
1016082,1,NA,200000,200000,0
1016082,2,NA,200000,200000,0
1016082,3,NA,200000,200000,0
1016082,4,NA,200000,200000,0
1016082,5,NA,200000,200000,0
1016082,6,NA,200000,200000,0
1016082,7,NA,200000,200000,0
1016082,8,NA,200000,200000,0
1016082,9,NA,200000,200000,0
1016082,10,NA,200000,200000,0
1016082,11,NA,200000,200000,0
1016082,12,NA,200000,200000,0
1016082,13,NA,200000,200000,0
1016082,14,NA,200000,200000,0
1016082,15,NA,200000,200000,0
1016082,16,NA,200000,200000,0
1016082,17,NA,200000,200000,0
1016082,18,NA,200000,200000,0
1016082,19,NA,200000,200000,0
1016082,20,NA,200000,200000,0
1016082,21,NA,200000,200000,0
1016082,22,NA,200000,200000,0
1016082,23,NA,200000,200000,0
1016082,24,NA,200000,200000,0
1016140,1,NA,200000,200000,0
1016140,2,NA,200000,200000,0
1016140,3,NA,200000,200000,0
1016140,4,NA,200000,200000,0
1016140,5,NA,200000,200000,0
1016140,6,NA,200000,200000,0
1016140,7,NA,200000,200000,0
1016140,8,NA,200000,200000,0
1016140,9,NA,200000,200000,0
1016140,10,NA,200000,200000,0
1016140,11,NA,200000,200000,0
1016140,12,NA,200000,200000,0
1016140,13,NA,200000,200000,0
1016140,14,NA,200000,200000,0
1016140,15,NA,200000,200000,0
1016140,16,NA,200000,200000,0
1016140,17,NA,200000,200000,0
1016140,18,NA,200000,200000,0
1016140,19,NA,200000,200000,0
1016140,20,NA,200000,200000,0
1016140,21,NA,200000,200000,0
1016140,22,NA,200000,200000,0
1016140,23,NA,200000,200000,0
1016140,24,NA,200000,200000,0
1016189,1,NA,200000,200000,0
1016189,2,NA,200000,200000,0
1016189,3,NA,200000,200000,0
1016189,4,NA,200000,200000,0
1016189,5,NA,200000,200000,0
1016189,6,NA,200000,200000,0
1016189,7,NA,200000,200000,0
1016189,8,NA,200000,200000,0
1016189,9,NA,200000,200000,0
1016189,10,NA,200000,200000,0
1016189,11,NA,200000,200000,0
1016189,12,NA,200000,200000,0
1016189,13,NA,200000,200000,0
1016189,14,NA,200000,200000,0
1016189,15,NA,200000,200000,0
1016189,16,NA,200000,200000,0
1016189,17,NA,200000,200000,0
1016189,18,NA,200000,200000,0
1016189,19,NA,200000,200000,0
1016189,20,NA,200000,200000,0
1016189,21,NA,200000,200000,0
1016189,22,NA,200000,200000,0
1016189,23,NA,200000,200000,0
1016189,24,NA,200000,200000,0
1016268,1,NA,200000,200000,0
1016268,2,NA,200000,200000,0
1016268,3,NA,200000,200000,0
1016268,4,NA,200000,200000,0
1016268,5,NA,200000,200000,0
1016268,6,76,200000,238000,38000
1016268,7,77,238000,301000,63000
1016268,8,75,301000,371000,70000
1016268,9,22,371000,397000,26000
1016268,10,NA,397000,397000,0
1016268,11,NA,397000,397000,0
1016268,12,39,397000,401000,4000
1016268,13,55,401000,402000,1000
1016268,14,40,402000,396000,-6000
1016268,15,NA,396000,396000,0
1016268,16,24,396000,375000,-21000
1016268,17,39,375000,360000,-15000
1016268,18,31,360000,343000,-17000
1016268,19,60,343000,346000,3000
1016268,20,66,346000,367000,21000
1016268,21,58,367000,393000,26000
1016268,22,59,393000,417000,24000
1016268,23,30,417000,418000,1000
1016268,24,18,418000,392000,-26000
1016270,1,NA,200000,200000,0
1016270,2,NA,200000,200000,0
1016270,3,NA,200000,200000,0
1016270,4,NA,200000,200000,0
1016270,5,NA,200000,200000,0
1016270,6,NA,200000,200000,0
1016270,7,NA,200000,200000,0
1016270,8,NA,200000,200000,0
1016270,9,NA,200000,200000,0
1016270,10,NA,200000,200000,0
1016270,11,NA,200000,200000,0
1016270,12,NA,200000,200000,0
1016270,13,NA,200000,200000,0
1016270,14,NA,200000,200000,0
1016270,15,NA,200000,200000,0
1016270,16,NA,200000,200000,0
1016270,17,NA,200000,200000,0
1016270,18,NA,200000,200000,0
1016270,19,NA,200000,200000,0
1016270,20,NA,200000,200000,0
1016270,21,NA,200000,200000,0
1016270,22,NA,200000,200000,0
1016270,23,NA,200000,200000,0
1016270,24,NA,200000,200000,0
1016433,1,NA,215000,215000,0
1016433,2,NA,215000,215000,0
1016433,3,NA,215000,215000,0
1016433,4,NA,215000,215000,0
1016433,5,NA,215000,215000,0
1016433,6,NA,215000,215000,0
1016433,7,NA,215000,215000,0
1016433,8,NA,215000,215000,0
1016433,9,NA,215000,215000,0
1016433,10,NA,215000,215000,0
1016433,11,NA,215000,215000,0
1016433,12,NA,215000,215000,0
1016433,13,NA,215000,215000,0
1016433,14,NA,215000,215000,0
1016433,15,NA,215000,215000,0
1016433,16,NA,215000,215000,0
1016433,17,NA,215000,215000,0
1016433,18,NA,215000,215000,0
1016433,19,NA,215000,215000,0
1016433,20,NA,215000,215000,0
1016433,21,NA,215000,215000,0
1016433,22,67,215000,244000,29000
1016433,23,32,244000,267000,23000
1016433,24,45,267000,290000,23000
1016825,1,NA,200000,200000,0
1016825,2,NA,200000,200000,0
1016825,3,24,200000,200000,0
1016825,4,16,200000,200000,0
1016825,5,55,200000,215000,15000
1016825,6,41,215000,240000,25000
1016825,7,63,240000,280000,40000
1016825,8,NA,280000,280000,0
1016825,9,NA,280000,280000,0
1016825,10,40,280000,309000,29000
1016825,11,68,309000,349000,40000
1016825,12,NA,349000,349000,0
1016825,13,93,349000,406000,57000
1016825,14,37,406000,434000,28000
1016825,15,99,434000,481000,47000
1016825,16,87,481000,531000,50000
1016825,17,41,531000,542000,11000
1016825,18,68,542000,547000,5000
1016825,19,22,547000,520000,-27000
1016825,20,NA,520000,520000,0
1016825,21,12,520000,463000,-57000
1016825,22,111,463000,466000,3000
1016825,23,71,466000,482000,16000
1016825,24,73,482000,503000,21000
1017043,1,NA,296000,296000,0
1017043,2,NA,296000,296000,0
1017043,3,46,296000,304000,8000
1017043,4,90,304000,349000,45000
1017043,5,46,349000,384000,35000
1017043,6,49,384000,408000,24000
1017043,7,23,408000,402000,-6000
1017043,8,34,402000,386000,-16000
1017043,9,21,386000,353000,-33000
1017043,10,15,353000,315000,-38000
1017043,11,24,315000,283000,-32000
1017043,12,60,283000,285000,2000
1017043,13,25,285000,282000,-3000
1017043,14,36,282000,287000,5000
1017043,15,NA,287000,287000,0
1017043,16,47,287000,300000,13000
1017043,17,NA,300000,300000,0
1017043,18,NA,300000,300000,0
1017043,19,NA,300000,300000,0
1017043,20,NA,300000,300000,0
1017043,21,NA,300000,300000,0
1017043,22,NA,300000,300000,0
1017043,23,NA,300000,300000,0
1017043,24,NA,300000,300000,0
1017051,1,105,461000,499000,38000
1017051,2,85,499000,547000,48000
1017051,3,75,547000,587000,40000
1017051,4,86,587000,621000,34000
1017051,5,96,621000,656000,35000
1017051,6,102,656000,692000,36000
1017051,7,79,692000,710000,18000
1017051,8,27,710000,679000,-31000
1017051,9,86,679000,662000,-17000
1017051,10,74,662000,645000,-17000
1017051,11,60,645000,623000,-22000
1017051,12,65,623000,605000,-18000
1017051,13,64,605000,593000,-12000
1017051,14,NA,593000,593000,0
1017051,15,47,593000,570000,-23000
1017051,16,100,570000,579000,9000
1017051,17,59,579000,580000,1000
1017051,18,45,580000,564000,-16000
1017051,19,NA,564000,564000,0
1017051,20,NA,564000,564000,0
1017051,21,36,564000,533000,-31000
1017051,22,54,533000,507000,-26000
1017051,23,65,507000,492000,-15000
1017051,24,99,492000,512000,20000
1017057,1,32,200000,207000,7000
1017057,2,27,207000,214000,7000
1017057,3,51,214000,237000,23000
1017057,4,NA,237000,237000,0
1017057,5,NA,237000,237000,0
1017057,6,NA,237000,237000,0
1017057,7,NA,237000,237000,0
1017057,8,NA,237000,237000,0
1017057,9,NA,237000,237000,0
1017057,10,37,237000,257000,20000
1017057,11,NA,257000,257000,0
1017057,12,NA,257000,257000,0
1017057,13,50,257000,283000,26000
1017057,14,NA,283000,283000,0
1017057,15,23,283000,291000,8000
1017057,16,61,291000,314000,23000
1017057,17,66,314000,345000,31000
1017057,18,37,345000,362000,17000
1017057,19,56,362000,380000,18000
1017057,20,31,380000,381000,1000
1017057,21,40,381000,374000,-7000
1017057,22,47,374000,370000,-4000
1017057,23,37,370000,363000,-7000
1017057,24,NA,363000,363000,0
1017059,1,NA,359000,359000,0
1017059,2,NA,359000,359000,0
1017059,3,NA,359000,359000,0
1017059,4,NA,359000,359000,0
1017059,5,NA,359000,359000,0
1017059,6,NA,359000,359000,0
1017059,7,NA,359000,359000,0
1017059,8,NA,359000,359000,0
1017059,9,NA,359000,359000,0
1017059,10,NA,359000,359000,0
1017059,11,NA,359000,359000,0
1017059,12,NA,359000,359000,0
1017059,13,NA,359000,359000,0
1017059,14,NA,359000,359000,0
1017059,15,NA,359000,359000,0
1017059,16,NA,359000,359000,0
1017059,17,NA,359000,359000,0
1017059,18,NA,359000,359000,0
1017059,19,NA,359000,359000,0
1017059,20,NA,359000,359000,0
1017059,21,NA,359000,359000,0
1017059,22,NA,359000,359000,0
1017059,23,NA,359000,359000,0
1017059,24,NA,359000,359000,0
1017063,1,NA,200000,200000,0
1017063,2,NA,200000,200000,0
1017063,3,NA,200000,200000,0
1017063,4,NA,200000,200000,0
1017063,5,NA,200000,200000,0
1017063,6,NA,200000,200000,0
1017063,7,NA,200000,200000,0
1017063,8,NA,200000,200000,0
1017063,9,NA,200000,200000,0
1017063,10,NA,200000,200000,0
1017063,11,NA,200000,200000,0
1017063,12,NA,200000,200000,0
1017063,13,NA,200000,200000,0
1017063,14,NA,200000,200000,0
1017063,15,NA,200000,200000,0
1017063,16,NA,200000,200000,0
1017063,17,NA,200000,200000,0
1017063,18,NA,200000,200000,0
1017063,19,NA,200000,200000,0
1017063,20,NA,200000,200000,0
1017063,21,NA,200000,200000,0
1017063,22,NA,200000,200000,0
1017063,23,NA,200000,200000,0
1017063,24,48,200000,216000,16000
1017065,1,NA,200000,200000,0
1017065,2,NA,200000,200000,0
1017065,3,NA,200000,200000,0
1017065,4,NA,200000,200000,0
1017065,5,NA,200000,200000,0
1017065,6,NA,200000,200000,0
1017065,7,NA,200000,200000,0
1017065,8,NA,200000,200000,0
1017065,9,NA,200000,200000,0
1017065,10,NA,200000,200000,0
1017065,11,NA,200000,200000,0
1017065,12,NA,200000,200000,0
1017065,13,NA,200000,200000,0
1017065,14,NA,200000,200000,0
1017065,15,NA,200000,200000,0
1017065,16,NA,200000,200000,0
1017065,17,NA,200000,200000,0
1017065,18,NA,200000,200000,0
1017065,19,NA,200000,200000,0
1017065,20,NA,200000,200000,0
1017065,21,NA,200000,200000,0
1017065,22,NA,200000,200000,0
1017065,23,NA,200000,200000,0
1017065,24,NA,200000,200000,0
1017067,1,49,200000,219000,19000
1017067,2,58,219000,257000,38000
1017067,3,66,257000,309000,52000
1017067,4,36,309000,340000,31000
1017067,5,57,340000,369000,29000
1017067,6,22,369000,368000,-1000
1017067,7,65,368000,379000,11000
1017067,8,34,379000,376000,-3000
1017067,9,59,376000,385000,9000
1017067,10,74,385000,410000,25000
1017067,11,42,410000,423000,13000
1017067,12,NA,423000,423000,0
1017067,13,68,423000,441000,18000
1017067,14,61,441000,461000,20000
1017067,15,75,461000,485000,24000
1017067,16,87,485000,520000,35000
1017067,17,76,520000,551000,31000
1017067,18,53,551000,560000,9000
1017067,19,90,560000,580000,20000
1017067,20,75,580000,595000,15000
1017067,21,54,595000,590000,-5000
1017067,22,59,590000,578000,-12000
1017067,23,52,578000,559000,-19000
1017067,24,84,559000,556000,-3000
1017077,1,NA,200000,200000,0
1017077,2,NA,200000,200000,0
1017077,3,NA,200000,200000,0
1017077,4,NA,200000,200000,0
1017077,5,NA,200000,200000,0
1017077,6,NA,200000,200000,0
1017077,7,NA,200000,200000,0
1017077,8,NA,200000,200000,0
1017077,9,NA,200000,200000,0
1017077,10,NA,200000,200000,0
1017077,11,NA,200000,200000,0
1017077,12,NA,200000,200000,0
1017077,13,NA,200000,200000,0
1017077,14,NA,200000,200000,0
1017077,15,NA,200000,200000,0
1017077,16,NA,200000,200000,0
1017077,17,NA,200000,200000,0
1017077,18,NA,200000,200000,0
1017077,19,NA,200000,200000,0
1017077,20,NA,200000,200000,0
1017077,21,NA,200000,200000,0
1017077,22,NA,200000,200000,0
1017077,23,NA,200000,200000,0
1017077,24,NA,200000,200000,0
1017078,1,NA,233000,233000,0
1017078,2,NA,233000,233000,0
1017078,3,NA,233000,233000,0
1017078,4,NA,233000,233000,0
1017078,5,NA,233000,233000,0
1017078,6,NA,233000,233000,0
1017078,7,NA,233000,233000,0
1017078,8,NA,233000,233000,0
1017078,9,NA,233000,233000,0
1017078,10,NA,233000,233000,0
1017078,11,NA,233000,233000,0
1017078,12,21,233000,228000,-5000
1017078,13,24,228000,222000,-6000
1017078,14,14,222000,211000,-11000
1017078,15,NA,211000,211000,0
1017078,16,NA,211000,211000,0
1017078,17,NA,211000,211000,0
1017078,18,NA,211000,211000,0
1017078,19,NA,211000,211000,0
1017078,20,NA,211000,211000,0
1017078,21,NA,211000,211000,0
1017078,22,NA,211000,211000,0
1017078,23,NA,211000,211000,0
1017078,24,NA,211000,211000,0
1017086,1,NA,200000,200000,0
1017086,2,NA,200000,200000,0
1017086,3,NA,200000,200000,0
1017086,4,NA,200000,200000,0
1017086,5,NA,200000,200000,0
1017086,6,NA,200000,200000,0
1017086,7,NA,200000,200000,0
1017086,8,NA,200000,200000,0
1017086,9,NA,200000,200000,0
1017086,10,NA,200000,200000,0
1017086,11,NA,200000,200000,0
1017086,12,NA,200000,200000,0
1017086,13,NA,200000,200000,0
1017086,14,NA,200000,200000,0
1017086,15,NA,200000,200000,0
1017086,16,NA,200000,200000,0
1017086,17,NA,200000,200000,0
1017086,18,NA,200000,200000,0
1017086,19,NA,200000,200000,0
1017086,20,NA,200000,200000,0
1017086,21,NA,200000,200000,0
1017086,22,NA,200000,200000,0
1017086,23,NA,200000,200000,0
1017086,24,62,200000,226000,26000
1017087,1,NA,224000,224000,0
1017087,2,NA,224000,224000,0
1017087,3,NA,224000,224000,0
1017087,4,NA,224000,224000,0
1017087,5,NA,224000,224000,0
1017087,6,NA,224000,224000,0
1017087,7,NA,224000,224000,0
1017087,8,NA,224000,224000,0
1017087,9,NA,224000,224000,0
1017087,10,NA,224000,224000,0
1017087,11,NA,224000,224000,0
1017087,12,NA,224000,224000,0
1017087,13,NA,224000,224000,0
1017087,14,NA,224000,224000,0
1017087,15,NA,224000,224000,0
1017087,16,NA,224000,224000,0
1017087,17,NA,224000,224000,0
1017087,18,NA,224000,224000,0
1017087,19,NA,224000,224000,0
1017087,20,NA,224000,224000,0
1017087,21,NA,224000,224000,0
1017087,22,NA,224000,224000,0
1017087,23,NA,224000,224000,0
1017087,24,NA,224000,224000,0
1017088,1,NA,541000,541000,0
1017088,2,NA,541000,541000,0
1017088,3,NA,541000,541000,0
1017088,4,NA,541000,541000,0
1017088,5,NA,541000,541000,0
1017088,6,23,541000,511000,-30000
1017088,7,83,511000,506000,-5000
1017088,8,61,506000,505000,-1000
1017088,9,85,505000,524000,19000
1017088,10,92,524000,559000,35000
1017088,11,97,559000,605000,46000
1017088,12,86,605000,640000,35000
1017088,13,91,640000,671000,31000
1017088,14,NA,671000,671000,0
1017088,15,105,671000,706000,35000
1017088,16,73,706000,718000,12000
1017088,17,70,718000,712000,-6000
1017088,18,63,712000,691000,-21000
1017088,19,43,691000,648000,-43000
1017088,20,73,648000,618000,-30000
1017088,21,55,618000,589000,-29000
1017088,22,108,589000,600000,11000
1017088,23,90,600000,623000,23000
1017088,24,79,623000,642000,19000
1017089,1,NA,200000,200000,0
1017089,2,NA,200000,200000,0
1017089,3,NA,200000,200000,0
1017089,4,NA,200000,200000,0
1017089,5,NA,200000,200000,0
1017089,6,NA,200000,200000,0
1017089,7,NA,200000,200000,0
1017089,8,NA,200000,200000,0
1017089,9,NA,200000,200000,0
1017089,10,NA,200000,200000,0
1017089,11,NA,200000,200000,0
1017089,12,NA,200000,200000,0
1017089,13,NA,200000,200000,0
1017089,14,NA,200000,200000,0
1017089,15,NA,200000,200000,0
1017089,16,NA,200000,200000,0
1017089,17,NA,200000,200000,0
1017089,18,NA,200000,200000,0
1017089,19,NA,200000,200000,0
1017089,20,NA,200000,200000,0
1017089,21,NA,200000,200000,0
1017089,22,NA,200000,200000,0
1017089,23,NA,200000,200000,0
1017089,24,NA,200000,200000,0
1017091,1,NA,232000,232000,0
1017091,2,NA,232000,232000,0
1017091,3,NA,232000,232000,0
1017091,4,NA,232000,232000,0
1017091,5,NA,232000,232000,0
1017091,6,NA,232000,232000,0
1017091,7,NA,232000,232000,0
1017091,8,NA,232000,232000,0
1017091,9,NA,232000,232000,0
1017091,10,NA,232000,232000,0
1017091,11,NA,232000,232000,0
1017091,12,NA,232000,232000,0
1017091,13,NA,232000,232000,0
1017091,14,NA,232000,232000,0
1017091,15,NA,232000,232000,0
1017091,16,NA,232000,232000,0
1017091,17,NA,232000,232000,0
1017091,18,NA,232000,232000,0
1017091,19,NA,232000,232000,0
1017091,20,NA,232000,232000,0
1017091,21,NA,232000,232000,0
1017091,22,NA,232000,232000,0
1017091,23,33,232000,235000,3000
1017091,24,61,235000,260000,25000
1017093,1,NA,394000,394000,0
1017093,2,78,394000,417000,23000
1017093,3,39,417000,428000,11000
1017093,4,26,428000,416000,-12000
1017093,5,45,416000,405000,-11000
1017093,6,NA,405000,405000,0
1017093,7,NA,405000,405000,0
1017093,8,NA,405000,405000,0
1017093,9,NA,405000,405000,0
1017093,10,NA,405000,405000,0
1017093,11,NA,405000,405000,0
1017093,12,NA,405000,405000,0
1017093,13,NA,405000,405000,0
1017093,14,NA,405000,405000,0
1017093,15,NA,405000,405000,0
1017093,16,NA,405000,405000,0
1017093,17,NA,405000,405000,0
1017093,18,NA,405000,405000,0
1017093,19,NA,405000,405000,0
1017093,20,NA,405000,405000,0
1017093,21,NA,405000,405000,0
1017093,22,NA,405000,405000,0
1017093,23,NA,405000,405000,0
1017093,24,NA,405000,405000,0
1017094,1,89,497000,520000,23000
1017094,2,63,520000,540000,20000
1017094,3,75,540000,561000,21000
1017094,4,45,561000,558000,-3000
1017094,5,67,558000,555000,-3000
1017094,6,79,555000,562000,7000
1017094,7,NA,562000,562000,0
1017094,8,50,562000,554000,-8000
1017094,9,NA,554000,554000,0
1017094,10,74,554000,554000,0
1017094,11,24,554000,527000,-27000
1017094,12,60,527000,507000,-20000
1017094,13,91,507000,516000,9000
1017094,14,NA,516000,516000,0
1017094,15,39,516000,509000,-7000
1017094,16,81,509000,521000,12000
1017094,17,86,521000,548000,27000
1017094,18,88,548000,579000,31000
1017094,19,41,579000,577000,-2000
1017094,20,73,577000,580000,3000
1017094,21,90,580000,594000,14000
1017094,22,77,594000,604000,10000
1017094,23,104,604000,633000,29000
1017094,24,89,633000,661000,28000
1017095,1,46,200000,217000,17000
1017095,2,48,217000,246000,29000
1017095,3,51,246000,282000,36000
1017095,4,NA,282000,282000,0
1017095,5,NA,282000,282000,0
1017095,6,NA,282000,282000,0
1017095,7,NA,282000,282000,0
1017095,8,57,282000,319000,37000
1017095,9,41,319000,343000,24000
1017095,10,56,343000,365000,22000
1017095,11,49,365000,381000,16000
1017095,12,68,381000,404000,23000
1017095,13,10,404000,390000,-14000
1017095,14,20,390000,365000,-25000
1017095,15,NA,365000,365000,0
1017095,16,49,365000,350000,-15000
1017095,17,NA,350000,350000,0
1017095,18,NA,350000,350000,0
1017095,19,NA,350000,350000,0
1017095,20,NA,350000,350000,0
1017095,21,NA,350000,350000,0
1017095,22,NA,350000,350000,0
1017095,23,NA,350000,350000,0
1017095,24,44,350000,340000,-10000
1017109,1,55,514000,511000,-3000
1017109,2,86,511000,529000,18000
1017109,3,62,529000,541000,12000
1017109,4,87,541000,566000,25000
1017109,5,16,566000,545000,-21000
1017109,6,107,545000,562000,17000
1017109,7,87,562000,585000,23000
1017109,8,79,585000,608000,23000
1017109,9,76,608000,624000,16000
1017109,10,29,624000,604000,-20000
1017109,11,79,604000,592000,-12000
1017109,12,48,592000,566000,-26000
1017109,13,60,566000,546000,-20000
1017109,14,NA,546000,546000,0
1017109,15,50,546000,526000,-20000
1017109,16,61,526000,517000,-9000
1017109,17,25,517000,484000,-33000
1017109,18,NA,484000,484000,0
1017109,19,NA,484000,484000,0
1017109,20,66,484000,472000,-12000
1017109,21,90,472000,489000,17000
1017109,22,60,489000,503000,14000
1017109,23,102,503000,542000,39000
1017109,24,94,542000,587000,45000
1017110,1,102,634000,655000,21000
1017110,2,65,655000,663000,8000
1017110,3,85,663000,674000,11000
1017110,4,96,674000,691000,17000
1017110,5,67,691000,691000,0
1017110,6,NA,691000,691000,0
1017110,7,77,691000,686000,-5000
1017110,8,52,686000,663000,-23000
1017110,9,NA,663000,663000,0
1017110,10,NA,663000,663000,0
1017110,11,NA,663000,663000,0
1017110,12,NA,663000,663000,0
1017110,13,NA,663000,663000,0
1017110,14,NA,663000,663000,0
1017110,15,NA,663000,663000,0
1017110,16,91,663000,657000,-6000
1017110,17,81,657000,655000,-2000
1017110,18,87,655000,662000,7000
1017110,19,73,662000,664000,2000
1017110,20,58,664000,652000,-12000
1017110,21,95,652000,655000,3000
1017110,22,76,655000,655000,0
1017110,23,36,655000,625000,-30000
1017110,24,57,625000,593000,-32000
1017114,1,NA,489000,489000,0
1017114,2,NA,489000,489000,0
1017114,3,NA,489000,489000,0
1017114,4,53,489000,484000,-5000
1017114,5,44,484000,473000,-11000
1017114,6,NA,473000,473000,0
1017114,7,10,473000,432000,-41000
1017114,8,NA,432000,432000,0
1017114,9,NA,432000,432000,0
1017114,10,NA,432000,432000,0
1017114,11,NA,432000,432000,0
1017114,12,NA,432000,432000,0
1017114,13,NA,432000,432000,0
1017114,14,NA,432000,432000,0
1017114,15,NA,432000,432000,0
1017114,16,NA,432000,432000,0
1017114,17,NA,432000,432000,0
1017114,18,NA,432000,432000,0
1017114,19,NA,432000,432000,0
1017114,20,NA,432000,432000,0
1017114,21,NA,432000,432000,0
1017114,22,NA,432000,432000,0
1017114,23,NA,432000,432000,0
1017114,24,NA,432000,432000,0
1017115,1,NA,200000,200000,0
1017115,2,NA,200000,200000,0
1017115,3,NA,200000,200000,0
1017115,4,NA,200000,200000,0
1017115,5,NA,200000,200000,0
1017115,6,NA,200000,200000,0
1017115,7,NA,200000,200000,0
1017115,8,NA,200000,200000,0
1017115,9,NA,200000,200000,0
1017115,10,NA,200000,200000,0
1017115,11,NA,200000,200000,0
1017115,12,NA,200000,200000,0
1017115,13,NA,200000,200000,0
1017115,14,NA,200000,200000,0
1017115,15,NA,200000,200000,0
1017115,16,NA,200000,200000,0
1017115,17,NA,200000,200000,0
1017115,18,NA,200000,200000,0
1017115,19,NA,200000,200000,0
1017115,20,NA,200000,200000,0
1017115,21,NA,200000,200000,0
1017115,22,NA,200000,200000,0
1017115,23,NA,200000,200000,0
1017115,24,NA,200000,200000,0
1017118,1,46,537000,525000,-12000
1017118,2,56,525000,513000,-12000
1017118,3,38,513000,490000,-23000
1017118,4,NA,490000,490000,0
1017118,5,NA,490000,490000,0
1017118,6,NA,490000,490000,0
1017118,7,NA,490000,490000,0
1017118,8,NA,490000,490000,0
1017118,9,NA,490000,490000,0
1017118,10,NA,490000,490000,0
1017118,11,NA,490000,490000,0
1017118,12,NA,490000,490000,0
1017118,13,NA,490000,490000,0
1017118,14,NA,490000,490000,0
1017118,15,NA,490000,490000,0
1017118,16,NA,490000,490000,0
1017118,17,NA,490000,490000,0
1017118,18,85,490000,493000,3000
1017118,19,68,493000,504000,11000
1017118,20,16,504000,482000,-22000
1017118,21,57,482000,468000,-14000
1017118,22,41,468000,450000,-18000
1017118,23,58,450000,439000,-11000
1017118,24,80,439000,451000,12000
1017122,1,NA,200000,200000,0
1017122,2,NA,200000,200000,0
1017122,3,NA,200000,200000,0
1017122,4,NA,200000,200000,0
1017122,5,NA,200000,200000,0
1017122,6,NA,200000,200000,0
1017122,7,NA,200000,200000,0
1017122,8,NA,200000,200000,0
1017122,9,NA,200000,200000,0
1017122,10,NA,200000,200000,0
1017122,11,NA,200000,200000,0
1017122,12,NA,200000,200000,0
1017122,13,NA,200000,200000,0
1017122,14,NA,200000,200000,0
1017122,15,NA,200000,200000,0
1017122,16,NA,200000,200000,0
1017122,17,NA,200000,200000,0
1017122,18,NA,200000,200000,0
1017122,19,NA,200000,200000,0
1017122,20,NA,200000,200000,0
1017122,21,NA,200000,200000,0
1017122,22,NA,200000,200000,0
1017122,23,NA,200000,200000,0
1017122,24,NA,200000,200000,0
1017124,1,NA,356000,356000,0
1017124,2,NA,356000,356000,0
1017124,3,NA,356000,356000,0
1017124,4,NA,356000,356000,0
1017124,5,63,356000,371000,15000
1017124,6,49,371000,386000,15000
1017124,7,NA,386000,386000,0
1017124,8,NA,386000,386000,0
1017124,9,NA,386000,386000,0
1017124,10,NA,386000,386000,0
1017124,11,NA,386000,386000,0
1017124,12,NA,386000,386000,0
1017124,13,NA,386000,386000,0
1017124,14,NA,386000,386000,0
1017124,15,NA,386000,386000,0
1017124,16,NA,386000,386000,0
1017124,17,NA,386000,386000,0
1017124,18,NA,386000,386000,0
1017124,19,15,386000,373000,-13000
1017124,20,NA,373000,373000,0
1017124,21,NA,373000,373000,0
1017124,22,NA,373000,373000,0
1017124,23,40,373000,361000,-12000
1017124,24,NA,361000,361000,0
1017126,1,28,436000,420000,-16000
1017126,2,10,420000,379000,-41000
1017126,3,NA,379000,379000,0
1017126,4,NA,379000,379000,0
1017126,5,NA,379000,379000,0
1017126,6,NA,379000,379000,0
1017126,7,NA,379000,379000,0
1017126,8,NA,379000,379000,0
1017126,9,NA,379000,379000,0
1017126,10,NA,379000,379000,0
1017126,11,NA,379000,379000,0
1017126,12,NA,379000,379000,0
1017126,13,NA,379000,379000,0
1017126,14,NA,379000,379000,0
1017126,15,NA,379000,379000,0
1017126,16,NA,379000,379000,0
1017126,17,NA,379000,379000,0
1017126,18,22,379000,336000,-43000
1017126,19,NA,336000,336000,0
1017126,20,NA,336000,336000,0
1017126,21,NA,336000,336000,0
1017126,22,NA,336000,336000,0
1017126,23,NA,336000,336000,0
1017126,24,NA,336000,336000,0
1017128,1,NA,200000,200000,0
1017128,2,NA,200000,200000,0
1017128,3,NA,200000,200000,0
1017128,4,NA,200000,200000,0
1017128,5,NA,200000,200000,0
1017128,6,NA,200000,200000,0
1017128,7,NA,200000,200000,0
1017128,8,NA,200000,200000,0
1017128,9,NA,200000,200000,0
1017128,10,NA,200000,200000,0
1017128,11,NA,200000,200000,0
1017128,12,NA,200000,200000,0
1017128,13,NA,200000,200000,0
1017128,14,NA,200000,200000,0
1017128,15,NA,200000,200000,0
1017128,16,9,200000,200000,0
1017128,17,NA,200000,200000,0
1017128,18,NA,200000,200000,0
1017128,19,NA,200000,200000,0
1017128,20,55,200000,205000,5000
1017128,21,55,205000,237000,32000
1017128,22,NA,237000,237000,0
1017128,23,NA,237000,237000,0
1017128,24,NA,237000,237000,0
1017255,1,8,274000,257000,-17000
1017255,2,NA,257000,257000,0
1017255,3,NA,257000,257000,0
1017255,4,NA,257000,257000,0
1017255,5,NA,257000,257000,0
1017255,6,NA,257000,257000,0
1017255,7,NA,257000,257000,0
1017255,8,20,257000,236000,-21000
1017255,9,62,236000,248000,12000
1017255,10,37,248000,262000,14000
1017255,11,9,262000,256000,-6000
1017255,12,NA,256000,256000,0
1017255,13,NA,256000,256000,0
1017255,14,NA,256000,256000,0
1017255,15,NA,256000,256000,0
1017255,16,NA,256000,256000,0
1017255,17,NA,256000,256000,0
1017255,18,NA,256000,256000,0
1017255,19,48,256000,267000,11000
1017255,20,75,267000,303000,36000
1017255,21,61,303000,340000,37000
1017255,22,8,340000,341000,1000
1017255,23,NA,341000,341000,0
1017255,24,62,341000,356000,15000
1017396,1,NA,352000,352000,0
1017396,2,NA,352000,352000,0
1017396,3,NA,352000,352000,0
1017396,4,55,352000,361000,9000
1017396,5,33,361000,361000,0
1017396,6,61,361000,376000,15000
1017396,7,NA,376000,376000,0
1017396,8,NA,376000,376000,0
1017396,9,34,376000,376000,0
1017396,10,75,376000,397000,21000
1017396,11,77,397000,431000,34000
1017396,12,NA,431000,431000,0
1017396,13,NA,431000,431000,0
1017396,14,20,431000,433000,2000
1017396,15,52,433000,432000,-1000
1017396,16,48,432000,429000,-3000
1017396,17,13,429000,396000,-33000
1017396,18,34,396000,366000,-30000
1017396,19,77,366000,374000,8000
1017396,20,68,374000,396000,22000
1017396,21,65,396000,425000,29000
1017396,22,41,425000,439000,14000
1017396,23,56,439000,449000,10000
1017396,24,22,449000,427000,-22000
1017665,1,68,200000,233000,33000
1017665,2,27,233000,257000,24000
1017665,3,NA,257000,257000,0
1017665,4,NA,257000,257000,0
1017665,5,NA,257000,257000,0
1017665,6,NA,257000,257000,0
1017665,7,NA,257000,257000,0
1017665,8,NA,257000,257000,0
1017665,9,NA,257000,257000,0
1017665,10,NA,257000,257000,0
1017665,11,NA,257000,257000,0
1017665,12,-3,257000,247000,-10000
1017665,13,NA,247000,247000,0
1017665,14,NA,247000,247000,0
1017665,15,NA,247000,247000,0
1017665,16,NA,247000,247000,0
1017665,17,NA,247000,247000,0
1017665,18,NA,247000,247000,0
1017665,19,NA,247000,247000,0
1017665,20,NA,247000,247000,0
1017665,21,NA,247000,247000,0
1017665,22,NA,247000,247000,0
1017665,23,NA,247000,247000,0
1017665,24,NA,247000,247000,0
1017700,1,43,354000,356000,2000
1017700,2,50,356000,363000,7000
1017700,3,77,363000,394000,31000
1017700,4,65,394000,427000,33000
1017700,5,49,427000,447000,20000
1017700,6,26,447000,439000,-8000
1017700,7,NA,439000,439000,0
1017700,8,48,439000,429000,-10000
1017700,9,35,429000,407000,-22000
1017700,10,35,407000,384000,-23000
1017700,11,56,384000,379000,-5000
1017700,12,45,379000,379000,0
1017700,13,38,379000,374000,-5000
1017700,14,NA,374000,374000,0
1017700,15,NA,374000,374000,0
1017700,16,NA,374000,374000,0
1017700,17,NA,374000,374000,0
1017700,18,62,374000,385000,11000
1017700,19,45,385000,392000,7000
1017700,20,43,392000,393000,1000
1017700,21,62,393000,404000,11000
1017700,22,36,404000,403000,-1000
1017700,23,80,403000,423000,20000
1017700,24,NA,423000,423000,0
1017703,1,49,200000,219000,19000
1017703,2,26,219000,234000,15000
1017703,3,61,234000,268000,34000
1017703,4,58,268000,307000,39000
1017703,5,46,307000,338000,31000
1017703,6,57,338000,367000,29000
1017703,7,51,367000,389000,22000
1017703,8,44,389000,398000,9000
1017703,9,39,398000,396000,-2000
1017703,10,39,396000,387000,-9000
1017703,11,28,387000,368000,-19000
1017703,12,68,368000,373000,5000
1017703,13,33,373000,369000,-4000
1017703,14,NA,369000,369000,0
1017703,15,50,369000,374000,5000
1017703,16,48,374000,380000,6000
1017703,17,53,380000,390000,10000
1017703,18,37,390000,387000,-3000
1017703,19,31,387000,376000,-11000
1017703,20,38,376000,363000,-13000
1017703,21,35,363000,349000,-14000
1017703,22,47,349000,344000,-5000
1017703,23,75,344000,367000,23000
1017703,24,48,367000,384000,17000
1017718,1,NA,400000,400000,0
1017718,2,NA,400000,400000,0
1017718,3,NA,400000,400000,0
1017718,4,NA,400000,400000,0
1017718,5,NA,400000,400000,0
1017718,6,18,400000,379000,-21000
1017718,7,7,379000,336000,-43000
1017718,8,NA,336000,336000,0
1017718,9,NA,336000,336000,0
1017718,10,17,336000,292000,-44000
1017718,11,50,292000,276000,-16000
1017718,12,37,276000,273000,-3000
1017718,13,39,273000,280000,7000
1017718,14,NA,280000,280000,0
1017718,15,14,280000,274000,-6000
1017718,16,47,274000,281000,7000
1017718,17,42,281000,289000,8000
1017718,18,NA,289000,289000,0
1017718,19,42,289000,299000,10000
1017718,20,20,299000,295000,-4000
1017718,21,NA,295000,295000,0
1017718,22,NA,295000,295000,0
1017718,23,NA,295000,295000,0
1017718,24,NA,295000,295000,0
1017720,1,NA,200000,200000,0
1017720,2,NA,200000,200000,0
1017720,3,76,200000,238000,38000
1017720,4,48,238000,281000,43000
1017720,5,29,281000,306000,25000
1017720,6,50,306000,330000,24000
1017720,7,40,330000,341000,11000
1017720,8,41,341000,344000,3000
1017720,9,65,344000,363000,19000
1017720,10,43,363000,375000,12000
1017720,11,49,375000,385000,10000
1017720,12,77,385000,413000,28000
1017720,13,49,413000,429000,16000
1017720,14,NA,429000,429000,0
1017720,15,45,429000,434000,5000
1017720,16,NA,434000,434000,0
1017720,17,NA,434000,434000,0
1017720,18,28,434000,420000,-14000
1017720,19,51,420000,410000,-10000
1017720,20,64,410000,413000,3000
1017720,21,71,413000,431000,18000
1017720,22,40,431000,436000,5000
1017720,23,57,436000,445000,9000
1017720,24,58,445000,450000,5000
1017751,1,NA,200000,200000,0
1017751,2,NA,200000,200000,0
1017751,3,NA,200000,200000,0
1017751,4,NA,200000,200000,0
1017751,5,NA,200000,200000,0
1017751,6,NA,200000,200000,0
1017751,7,NA,200000,200000,0
1017751,8,NA,200000,200000,0
1017751,9,NA,200000,200000,0
1017751,10,NA,200000,200000,0
1017751,11,6,200000,200000,0
1017751,12,17,200000,200000,0
1017751,13,50,200000,200000,0
1017751,14,NA,200000,200000,0
1017751,15,NA,200000,200000,0
1017751,16,NA,200000,200000,0
1017751,17,NA,200000,200000,0
1017751,18,29,200000,200000,0
1017751,19,8,200000,200000,0
1017751,20,NA,200000,200000,0
1017751,21,NA,200000,200000,0
1017751,22,64,200000,227000,27000
1017751,23,62,227000,268000,41000
1017751,24,NA,268000,268000,0
1017754,1,NA,200000,200000,0
1017754,2,NA,200000,200000,0
1017754,3,NA,200000,200000,0
1017754,4,NA,200000,200000,0
1017754,5,NA,200000,200000,0
1017754,6,NA,200000,200000,0
1017754,7,NA,200000,200000,0
1017754,8,NA,200000,200000,0
1017754,9,NA,200000,200000,0
1017754,10,NA,200000,200000,0
1017754,11,NA,200000,200000,0
1017754,12,NA,200000,200000,0
1017754,13,NA,200000,200000,0
1017754,14,NA,200000,200000,0
1017754,15,NA,200000,200000,0
1017754,16,NA,200000,200000,0
1017754,17,NA,200000,200000,0
1017754,18,NA,200000,200000,0
1017754,19,NA,200000,200000,0
1017754,20,NA,200000,200000,0
1017754,21,NA,200000,200000,0
1017754,22,NA,200000,200000,0
1017754,23,NA,200000,200000,0
1017754,24,NA,200000,200000,0
1017757,1,NA,200000,200000,0
1017757,2,NA,200000,200000,0
1017757,3,NA,200000,200000,0
1017757,4,NA,200000,200000,0
1017757,5,NA,200000,200000,0
1017757,6,NA,200000,200000,0
1017757,7,NA,200000,200000,0
1017757,8,NA,200000,200000,0
1017757,9,NA,200000,200000,0
1017757,10,NA,200000,200000,0
1017757,11,NA,200000,200000,0
1017757,12,NA,200000,200000,0
1017757,13,NA,200000,200000,0
1017757,14,NA,200000,200000,0
1017757,15,NA,200000,200000,0
1017757,16,NA,200000,200000,0
1017757,17,NA,200000,200000,0
1017757,18,NA,200000,200000,0
1017757,19,NA,200000,200000,0
1017757,20,NA,200000,200000,0
1017757,21,NA,200000,200000,0
1017757,22,NA,200000,200000,0
1017757,23,NA,200000,200000,0
1017757,24,NA,200000,200000,0
1017932,1,NA,200000,200000,0
1017932,2,NA,200000,200000,0
1017932,3,NA,200000,200000,0
1017932,4,NA,200000,200000,0
1017932,5,NA,200000,200000,0
1017932,6,NA,200000,200000,0
1017932,7,NA,200000,200000,0
1017932,8,NA,200000,200000,0
1017932,9,NA,200000,200000,0
1017932,10,NA,200000,200000,0
1017932,11,NA,200000,200000,0
1017932,12,NA,200000,200000,0
1017932,13,NA,200000,200000,0
1017932,14,NA,200000,200000,0
1017932,15,NA,200000,200000,0
1017932,16,NA,200000,200000,0
1017932,17,NA,200000,200000,0
1017932,18,57,200000,223000,23000
1017932,19,NA,223000,223000,0
1017932,20,NA,223000,223000,0
1017932,21,NA,223000,223000,0
1017932,22,NA,223000,223000,0
1017932,23,NA,223000,223000,0
1017932,24,NA,223000,223000,0
1017933,1,58,212000,237000,25000
1017933,2,47,237000,269000,32000
1017933,3,56,269000,309000,40000
1017933,4,39,309000,334000,25000
1017933,5,NA,334000,334000,0
1017933,6,30,334000,340000,6000
1017933,7,NA,340000,340000,0
1017933,8,34,340000,336000,-4000
1017933,9,11,336000,310000,-26000
1017933,10,47,310000,300000,-10000
1017933,11,NA,300000,300000,0
1017933,12,NA,300000,300000,0
1017933,13,NA,300000,300000,0
1017933,14,NA,300000,300000,0
1017933,15,NA,300000,300000,0
1017933,16,NA,300000,300000,0
1017933,17,NA,300000,300000,0
1017933,18,NA,300000,300000,0
1017933,19,NA,300000,300000,0
1017933,20,27,300000,289000,-11000
1017933,21,9,289000,266000,-23000
1017933,22,NA,266000,266000,0
1017933,23,NA,266000,266000,0
1017933,24,NA,266000,266000,0
1017961,1,NA,200000,200000,0
1017961,2,NA,200000,200000,0
1017961,3,NA,200000,200000,0
1017961,4,NA,200000,200000,0
1017961,5,NA,200000,200000,0
1017961,6,NA,200000,200000,0
1017961,7,NA,200000,200000,0
1017961,8,NA,200000,200000,0
1017961,9,NA,200000,200000,0
1017961,10,NA,200000,200000,0
1017961,11,NA,200000,200000,0
1017961,12,NA,200000,200000,0
1017961,13,NA,200000,200000,0
1017961,14,NA,200000,200000,0
1017961,15,NA,200000,200000,0
1017961,16,NA,200000,200000,0
1017961,17,NA,200000,200000,0
1017961,18,NA,200000,200000,0
1017961,19,NA,200000,200000,0
1017961,20,NA,200000,200000,0
1017961,21,NA,200000,200000,0
1017961,22,NA,200000,200000,0
1017961,23,NA,200000,200000,0
1017961,24,NA,200000,200000,0
1017970,1,NA,200000,200000,0
1017970,2,NA,200000,200000,0
1017970,3,NA,200000,200000,0
1017970,4,NA,200000,200000,0
1017970,5,NA,200000,200000,0
1017970,6,NA,200000,200000,0
1017970,7,NA,200000,200000,0
1017970,8,NA,200000,200000,0
1017970,9,NA,200000,200000,0
1017970,10,NA,200000,200000,0
1017970,11,NA,200000,200000,0
1017970,12,NA,200000,200000,0
1017970,13,NA,200000,200000,0
1017970,14,NA,200000,200000,0
1017970,15,NA,200000,200000,0
1017970,16,NA,200000,200000,0
1017970,17,NA,200000,200000,0
1017970,18,NA,200000,200000,0
1017970,19,NA,200000,200000,0
1017970,20,NA,200000,200000,0
1017970,21,NA,200000,200000,0
1017970,22,NA,200000,200000,0
1017970,23,NA,200000,200000,0
1017970,24,NA,200000,200000,0
1018016,1,NA,200000,200000,0
1018016,2,NA,200000,200000,0
1018016,3,NA,200000,200000,0
1018016,4,NA,200000,200000,0
1018016,5,64,200000,229000,29000
1018016,6,68,229000,280000,51000
1018016,7,44,280000,322000,42000
1018016,8,54,322000,358000,36000
1018016,9,95,358000,414000,56000
1018016,10,85,414000,470000,56000
1018016,11,70,470000,511000,41000
1018016,12,NA,511000,511000,0
1018016,13,64,511000,538000,27000
1018016,14,NA,538000,538000,0
1018016,15,91,538000,572000,34000
1018016,16,79,572000,596000,24000
1018016,17,56,596000,598000,2000
1018016,18,NA,598000,598000,0
1018016,19,59,598000,589000,-9000
1018016,20,22,589000,549000,-40000
1018016,21,30,549000,497000,-52000
1018016,22,NA,497000,497000,0
1018016,23,NA,497000,497000,0
1018016,24,NA,497000,497000,0
1018018,1,NA,578000,578000,0
1018018,2,NA,578000,578000,0
1018018,3,NA,578000,578000,0
1018018,4,NA,578000,578000,0
1018018,5,NA,578000,578000,0
1018018,6,NA,578000,578000,0
1018018,7,NA,578000,578000,0
1018018,8,89,578000,592000,14000
1018018,9,27,592000,572000,-20000
1018018,10,NA,572000,572000,0
1018018,11,38,572000,537000,-35000
1018018,12,NA,537000,537000,0
1018018,13,34,537000,492000,-45000
1018018,14,14,492000,437000,-55000
1018018,15,16,437000,376000,-61000
1018018,16,44,376000,343000,-33000
1018018,17,47,343000,331000,-12000
1018018,18,76,331000,353000,22000
1018018,19,60,353000,385000,32000
1018018,20,48,385000,407000,22000
1018018,21,36,407000,411000,4000
1018018,22,54,411000,414000,3000
1018018,23,58,414000,418000,4000
1018018,24,25,418000,402000,-16000
1018020,1,NA,200000,200000,0
1018020,2,NA,200000,200000,0
1018020,3,NA,200000,200000,0
1018020,4,NA,200000,200000,0
1018020,5,NA,200000,200000,0
1018020,6,NA,200000,200000,0
1018020,7,NA,200000,200000,0
1018020,8,NA,200000,200000,0
1018020,9,NA,200000,200000,0
1018020,10,NA,200000,200000,0
1018020,11,NA,200000,200000,0
1018020,12,NA,200000,200000,0
1018020,13,NA,200000,200000,0
1018020,14,NA,200000,200000,0
1018020,15,NA,200000,200000,0
1018020,16,NA,200000,200000,0
1018020,17,NA,200000,200000,0
1018020,18,NA,200000,200000,0
1018020,19,NA,200000,200000,0
1018020,20,NA,200000,200000,0
1018020,21,NA,200000,200000,0
1018020,22,NA,200000,200000,0
1018020,23,NA,200000,200000,0
1018020,24,NA,200000,200000,0
1018075,1,NA,403000,403000,0
1018075,2,NA,403000,403000,0
1018075,3,51,403000,405000,2000
1018075,4,45,405000,405000,0
1018075,5,NA,405000,405000,0
1018075,6,NA,405000,405000,0
1018075,7,NA,405000,405000,0
1018075,8,NA,405000,405000,0
1018075,9,NA,405000,405000,0
1018075,10,36,405000,396000,-9000
1018075,11,NA,396000,396000,0
1018075,12,NA,396000,396000,0
1018075,13,NA,396000,396000,0
1018075,14,NA,396000,396000,0
1018075,15,NA,396000,396000,0
1018075,16,NA,396000,396000,0
1018075,17,NA,396000,396000,0
1018075,18,NA,396000,396000,0
1018075,19,NA,396000,396000,0
1018075,20,NA,396000,396000,0
1018075,21,NA,396000,396000,0
1018075,22,NA,396000,396000,0
1018075,23,NA,396000,396000,0
1018075,24,79,396000,411000,15000
1018106,1,NA,200000,200000,0
1018106,2,NA,200000,200000,0
1018106,3,NA,200000,200000,0
1018106,4,NA,200000,200000,0
1018106,5,NA,200000,200000,0
1018106,6,NA,200000,200000,0
1018106,7,NA,200000,200000,0
1018106,8,NA,200000,200000,0
1018106,9,NA,200000,200000,0
1018106,10,NA,200000,200000,0
1018106,11,NA,200000,200000,0
1018106,12,NA,200000,200000,0
1018106,13,NA,200000,200000,0
1018106,14,NA,200000,200000,0
1018106,15,NA,200000,200000,0
1018106,16,NA,200000,200000,0
1018106,17,NA,200000,200000,0
1018106,18,NA,200000,200000,0
1018106,19,NA,200000,200000,0
1018106,20,NA,200000,200000,0
1018106,21,NA,200000,200000,0
1018106,22,NA,200000,200000,0
1018106,23,NA,200000,200000,0
1018106,24,NA,200000,200000,0
1018296,1,NA,200000,200000,0
1018296,2,NA,200000,200000,0
1018296,3,NA,200000,200000,0
1018296,4,NA,200000,200000,0
1018296,5,NA,200000,200000,0
1018296,6,NA,200000,200000,0
1018296,7,NA,200000,200000,0
1018296,8,NA,200000,200000,0
1018296,9,NA,200000,200000,0
1018296,10,NA,200000,200000,0
1018296,11,NA,200000,200000,0
1018296,12,NA,200000,200000,0
1018296,13,NA,200000,200000,0
1018296,14,NA,200000,200000,0
1018296,15,NA,200000,200000,0
1018296,16,NA,200000,200000,0
1018296,17,NA,200000,200000,0
1018296,18,NA,200000,200000,0
1018296,19,NA,200000,200000,0
1018296,20,NA,200000,200000,0
1018296,21,NA,200000,200000,0
1018296,22,NA,200000,200000,0
1018296,23,NA,200000,200000,0
1018296,24,NA,200000,200000,0
1018335,1,NA,369000,369000,0
1018335,2,NA,369000,369000,0
1018335,3,NA,369000,369000,0
1018335,4,NA,369000,369000,0
1018335,5,NA,369000,369000,0
1018335,6,NA,369000,369000,0
1018335,7,NA,369000,369000,0
1018335,8,NA,369000,369000,0
1018335,9,NA,369000,369000,0
1018335,10,NA,369000,369000,0
1018335,11,NA,369000,369000,0
1018335,12,NA,369000,369000,0
1018335,13,NA,369000,369000,0
1018335,14,NA,369000,369000,0
1018335,15,NA,369000,369000,0
1018335,16,NA,369000,369000,0
1018335,17,NA,369000,369000,0
1018335,18,NA,369000,369000,0
1018335,19,63,369000,382000,13000
1018335,20,NA,382000,382000,0
1018335,21,NA,382000,382000,0
1018335,22,NA,382000,382000,0
1018335,23,NA,382000,382000,0
1018335,24,NA,382000,382000,0
1018424,1,NA,200000,200000,0
1018424,2,NA,200000,200000,0
1018424,3,NA,200000,200000,0
1018424,4,NA,200000,200000,0
1018424,5,32,200000,206000,6000
1018424,6,NA,206000,206000,0
1018424,7,NA,206000,206000,0
1018424,8,NA,206000,206000,0
1018424,9,NA,206000,206000,0
1018424,10,NA,206000,206000,0
1018424,11,2,206000,200000,-6000
1018424,12,NA,200000,200000,0
1018424,13,NA,200000,200000,0
1018424,14,NA,200000,200000,0
1018424,15,NA,200000,200000,0
1018424,16,NA,200000,200000,0
1018424,17,NA,200000,200000,0
1018424,18,28,200000,200000,0
1018424,19,NA,200000,200000,0
1018424,20,NA,200000,200000,0
1018424,21,NA,200000,200000,0
1018424,22,NA,200000,200000,0
1018424,23,NA,200000,200000,0
1018424,24,NA,200000,200000,0
1018425,1,NA,200000,200000,0
1018425,2,NA,200000,200000,0
1018425,3,NA,200000,200000,0
1018425,4,NA,200000,200000,0
1018425,5,NA,200000,200000,0
1018425,6,NA,200000,200000,0
1018425,7,NA,200000,200000,0
1018425,8,NA,200000,200000,0
1018425,9,NA,200000,200000,0
1018425,10,NA,200000,200000,0
1018425,11,NA,200000,200000,0
1018425,12,NA,200000,200000,0
1018425,13,NA,200000,200000,0
1018425,14,NA,200000,200000,0
1018425,15,NA,200000,200000,0
1018425,16,NA,200000,200000,0
1018425,17,37,200000,209000,9000
1018425,18,44,209000,230000,21000
1018425,19,38,230000,251000,21000
1018425,20,35,251000,267000,16000
1018425,21,NA,267000,267000,0
1018425,22,NA,267000,267000,0
1018425,23,NA,267000,267000,0
1018425,24,NA,267000,267000,0
1018433,1,NA,200000,200000,0
1018433,2,23,200000,200000,0
1018433,3,33,200000,207000,7000
1018433,4,33,207000,218000,11000
1018433,5,48,218000,241000,23000
1018433,6,24,241000,253000,12000
1018433,7,42,253000,268000,15000
1018433,8,NA,268000,268000,0
1018433,9,NA,268000,268000,0
1018433,10,NA,268000,268000,0
1018433,11,28,268000,273000,5000
1018433,12,35,273000,276000,3000
1018433,13,10,276000,260000,-16000
1018433,14,37,260000,257000,-3000
1018433,15,NA,257000,257000,0
1018433,16,57,257000,272000,15000
1018433,17,35,272000,285000,13000
1018433,18,37,285000,295000,10000
1018433,19,36,295000,304000,9000
1018433,20,74,304000,334000,30000
1018433,21,25,334000,340000,6000
1018433,22,34,340000,339000,-1000
1018433,23,45,339000,341000,2000
1018433,24,45,341000,343000,2000
1018969,1,NA,200000,200000,0
1018969,2,NA,200000,200000,0
1018969,3,NA,200000,200000,0
1018969,4,NA,200000,200000,0
1018969,5,NA,200000,200000,0
1018969,6,NA,200000,200000,0
1018969,7,NA,200000,200000,0
1018969,8,NA,200000,200000,0
1018969,9,NA,200000,200000,0
1018969,10,NA,200000,200000,0
1018969,11,NA,200000,200000,0
1018969,12,NA,200000,200000,0
1018969,13,NA,200000,200000,0
1018969,14,NA,200000,200000,0
1018969,15,NA,200000,200000,0
1018969,16,NA,200000,200000,0
1018969,17,NA,200000,200000,0
1018969,18,NA,200000,200000,0
1018969,19,NA,200000,200000,0
1018969,20,NA,200000,200000,0
1018969,21,NA,200000,200000,0
1018969,22,NA,200000,200000,0
1018969,23,NA,200000,200000,0
1018969,24,NA,200000,200000,0
1019038,1,NA,300000,300000,0
1019038,2,NA,300000,300000,0
1019038,3,NA,300000,300000,0
1019038,4,NA,300000,300000,0
1019038,5,29,300000,295000,-5000
1019038,6,35,295000,292000,-3000
1019038,7,32,292000,289000,-3000
1019038,8,16,289000,274000,-15000
1019038,9,24,274000,259000,-15000
1019038,10,37,259000,255000,-4000
1019038,11,21,255000,246000,-9000
1019038,12,26,246000,239000,-7000
1019038,13,NA,239000,239000,0
1019038,14,7,239000,222000,-17000
1019038,15,NA,222000,222000,0
1019038,16,NA,222000,222000,0
1019038,17,NA,222000,222000,0
1019038,18,36,222000,218000,-4000
1019038,19,16,218000,208000,-10000
1019038,20,15,208000,200000,-8000
1019038,21,NA,200000,200000,0
1019038,22,NA,200000,200000,0
1019038,23,NA,200000,200000,0
1019038,24,NA,200000,200000,0
1019945,1,NA,200000,200000,0
1019945,2,NA,200000,200000,0
1019945,3,NA,200000,200000,0
1019945,4,NA,200000,200000,0
1019945,5,NA,200000,200000,0
1019945,6,NA,200000,200000,0
1019945,7,NA,200000,200000,0
1019945,8,NA,200000,200000,0
1019945,9,NA,200000,200000,0
1019945,10,NA,200000,200000,0
1019945,11,NA,200000,200000,0
1019945,12,NA,200000,200000,0
1019945,13,NA,200000,200000,0
1019945,14,NA,200000,200000,0
1019945,15,NA,200000,200000,0
1019945,16,NA,200000,200000,0
1019945,17,NA,200000,200000,0
1019945,18,NA,200000,200000,0
1019945,19,NA,200000,200000,0
1019945,20,NA,200000,200000,0
1019945,21,NA,200000,200000,0
1019945,22,NA,200000,200000,0
1019945,23,NA,200000,200000,0
1019945,24,NA,200000,200000,0
1020057,1,NA,256000,256000,0
1020057,2,NA,256000,256000,0
1020057,3,NA,256000,256000,0
1020057,4,NA,256000,256000,0
1020057,5,NA,256000,256000,0
1020057,6,NA,256000,256000,0
1020057,7,NA,256000,256000,0
1020057,8,NA,256000,256000,0
1020057,9,NA,256000,256000,0
1020057,10,NA,256000,256000,0
1020057,11,NA,256000,256000,0
1020057,12,NA,256000,256000,0
1020057,13,NA,256000,256000,0
1020057,14,NA,256000,256000,0
1020057,15,NA,256000,256000,0
1020057,16,9,256000,241000,-15000
1020057,17,NA,241000,241000,0
1020057,18,NA,241000,241000,0
1020057,19,NA,241000,241000,0
1020057,20,NA,241000,241000,0
1020057,21,NA,241000,241000,0
1020057,22,NA,241000,241000,0
1020057,23,NA,241000,241000,0
1020057,24,NA,241000,241000,0
1020066,1,NA,200000,200000,0
1020066,2,NA,200000,200000,0
1020066,3,NA,200000,200000,0
1020066,4,NA,200000,200000,0
1020066,5,NA,200000,200000,0
1020066,6,NA,200000,200000,0
1020066,7,NA,200000,200000,0
1020066,8,NA,200000,200000,0
1020066,9,NA,200000,200000,0
1020066,10,NA,200000,200000,0
1020066,11,NA,200000,200000,0
1020066,12,NA,200000,200000,0
1020066,13,NA,200000,200000,0
1020066,14,NA,200000,200000,0
1020066,15,NA,200000,200000,0
1020066,16,NA,200000,200000,0
1020066,17,NA,200000,200000,0
1020066,18,NA,200000,200000,0
1020066,19,NA,200000,200000,0
1020066,20,NA,200000,200000,0
1020066,21,NA,200000,200000,0
1020066,22,NA,200000,200000,0
1020066,23,NA,200000,200000,0
1020066,24,NA,200000,200000,0
1020072,1,NA,208000,208000,0
1020072,2,NA,208000,208000,0
1020072,3,NA,208000,208000,0
1020072,4,NA,208000,208000,0
1020072,5,NA,208000,208000,0
1020072,6,NA,208000,208000,0
1020072,7,NA,208000,208000,0
1020072,8,NA,208000,208000,0
1020072,9,NA,208000,208000,0
1020072,10,NA,208000,208000,0
1020072,11,NA,208000,208000,0
1020072,12,NA,208000,208000,0
1020072,13,NA,208000,208000,0
1020072,14,NA,208000,208000,0
1020072,15,NA,208000,208000,0
1020072,16,NA,208000,208000,0
1020072,17,NA,208000,208000,0
1020072,18,NA,208000,208000,0
1020072,19,NA,208000,208000,0
1020072,20,NA,208000,208000,0
1020072,21,NA,208000,208000,0
1020072,22,NA,208000,208000,0
1020072,23,NA,208000,208000,0
1020072,24,NA,208000,208000,0
1020104,1,NA,246000,246000,0
1020104,2,NA,246000,246000,0
1020104,3,NA,246000,246000,0
1020104,4,NA,246000,246000,0
1020104,5,NA,246000,246000,0
1020104,6,NA,246000,246000,0
1020104,7,NA,246000,246000,0
1020104,8,NA,246000,246000,0
1020104,9,NA,246000,246000,0
1020104,10,NA,246000,246000,0
1020104,11,NA,246000,246000,0
1020104,12,NA,246000,246000,0
1020104,13,NA,246000,246000,0
1020104,14,NA,246000,246000,0
1020104,15,NA,246000,246000,0
1020104,16,NA,246000,246000,0
1020104,17,NA,246000,246000,0
1020104,18,NA,246000,246000,0
1020104,19,NA,246000,246000,0
1020104,20,NA,246000,246000,0
1020104,21,NA,246000,246000,0
1020104,22,NA,246000,246000,0
1020104,23,19,246000,238000,-8000
1020104,24,NA,238000,238000,0
1020137,1,54,282000,298000,16000
1020137,2,42,298000,315000,17000
1020137,3,40,315000,329000,14000
1020137,4,66,329000,356000,27000
1020137,5,70,356000,392000,36000
1020137,6,49,392000,416000,24000
1020137,7,31,416000,416000,0
1020137,8,66,416000,427000,11000
1020137,9,52,427000,432000,5000
1020137,10,70,432000,446000,14000
1020137,11,59,446000,461000,15000
1020137,12,NA,461000,461000,0
1020137,13,50,461000,467000,6000
1020137,14,68,467000,481000,14000
1020137,15,31,481000,469000,-12000
1020137,16,40,469000,450000,-19000
1020137,17,44,450000,430000,-20000
1020137,18,39,430000,410000,-20000
1020137,19,67,410000,411000,1000
1020137,20,73,411000,432000,21000
1020137,21,43,432000,440000,8000
1020137,22,73,440000,461000,21000
1020137,23,26,461000,452000,-9000
1020137,24,48,452000,439000,-13000
1020250,1,NA,418000,418000,0
1020250,2,NA,418000,418000,0
1020250,3,NA,418000,418000,0
1020250,4,NA,418000,418000,0
1020250,5,NA,418000,418000,0
1020250,6,NA,418000,418000,0
1020250,7,21,418000,397000,-21000
1020250,8,85,397000,409000,12000
1020250,9,73,409000,436000,27000
1020250,10,NA,436000,436000,0
1020250,11,NA,436000,436000,0
1020250,12,NA,436000,436000,0
1020250,13,NA,436000,436000,0
1020250,14,32,436000,442000,6000
1020250,15,50,442000,444000,2000
1020250,16,0,444000,408000,-36000
1020250,17,73,408000,398000,-10000
1020250,18,115,398000,439000,41000
1020250,19,52,439000,469000,30000
1020250,20,62,469000,493000,24000
1020250,21,72,493000,520000,27000
1020250,22,48,520000,521000,1000
1020250,23,18,521000,485000,-36000
1020250,24,23,485000,437000,-48000
1020339,1,NA,200000,200000,0
1020339,2,NA,200000,200000,0
1020339,3,NA,200000,200000,0
1020339,4,NA,200000,200000,0
1020339,5,NA,200000,200000,0
1020339,6,NA,200000,200000,0
1020339,7,18,200000,200000,0
1020339,8,NA,200000,200000,0
1020339,9,NA,200000,200000,0
1020339,10,8,200000,200000,0
1020339,11,NA,200000,200000,0
1020339,12,NA,200000,200000,0
1020339,13,79,200000,213000,13000
1020339,14,82,213000,275000,62000
1020339,15,111,275000,370000,95000
1020339,16,93,370000,465000,95000
1020339,17,46,465000,516000,51000
1020339,18,NA,516000,516000,0
1020339,19,NA,516000,516000,0
1020339,20,NA,516000,516000,0
1020339,21,NA,516000,516000,0
1020339,22,NA,516000,516000,0
1020339,23,NA,516000,516000,0
1020339,24,NA,516000,516000,0
1020371,1,NA,200000,200000,0
1020371,2,NA,200000,200000,0
1020371,3,NA,200000,200000,0
1020371,4,NA,200000,200000,0
1020371,5,NA,200000,200000,0
1020371,6,NA,200000,200000,0
1020371,7,NA,200000,200000,0
1020371,8,NA,200000,200000,0
1020371,9,NA,200000,200000,0
1020371,10,NA,200000,200000,0
1020371,11,NA,200000,200000,0
1020371,12,NA,200000,200000,0
1020371,13,NA,200000,200000,0
1020371,14,NA,200000,200000,0
1020371,15,10,200000,200000,0
1020371,16,49,200000,202000,2000
1020371,17,43,202000,224000,22000
1020371,18,32,224000,242000,18000
1020371,19,36,242000,258000,16000
1020371,20,62,258000,290000,32000
1020371,21,37,290000,309000,19000
1020371,22,48,309000,327000,18000
1020371,23,30,327000,331000,4000
1020371,24,24,331000,320000,-11000
1020424,1,NA,200000,200000,0
1020424,2,NA,200000,200000,0
1020424,3,NA,200000,200000,0
1020424,4,NA,200000,200000,0
1020424,5,NA,200000,200000,0
1020424,6,NA,200000,200000,0
1020424,7,NA,200000,200000,0
1020424,8,NA,200000,200000,0
1020424,9,NA,200000,200000,0
1020424,10,NA,200000,200000,0
1020424,11,NA,200000,200000,0
1020424,12,NA,200000,200000,0
1020424,13,NA,200000,200000,0
1020424,14,NA,200000,200000,0
1020424,15,NA,200000,200000,0
1020424,16,NA,200000,200000,0
1020424,17,NA,200000,200000,0
1020424,18,NA,200000,200000,0
1020424,19,NA,200000,200000,0
1020424,20,NA,200000,200000,0
1020424,21,NA,200000,200000,0
1020424,22,NA,200000,200000,0
1020424,23,NA,200000,200000,0
1020424,24,NA,200000,200000,0
1020586,1,NA,200000,200000,0
1020586,2,NA,200000,200000,0
1020586,3,18,200000,200000,0
1020586,4,35,200000,201000,1000
1020586,5,32,201000,212000,11000
1020586,6,33,212000,225000,13000
1020586,7,50,225000,250000,25000
1020586,8,49,250000,279000,29000
1020586,9,68,279000,321000,42000
1020586,10,24,321000,336000,15000
1020586,11,46,336000,347000,11000
1020586,12,26,347000,341000,-6000
1020586,13,21,341000,320000,-21000
1020586,14,NA,320000,320000,0
1020586,15,NA,320000,320000,0
1020586,16,NA,320000,320000,0
1020586,17,NA,320000,320000,0
1020586,18,NA,320000,320000,0
1020586,19,NA,320000,320000,0
1020586,20,NA,320000,320000,0
1020586,21,10,320000,286000,-34000
1020586,22,26,286000,261000,-25000
1020586,23,NA,261000,261000,0
1020586,24,NA,261000,261000,0
1020594,1,NA,336000,336000,0
1020594,2,23,336000,324000,-12000
1020594,3,43,324000,319000,-5000
1020594,4,39,319000,318000,-1000
1020594,5,74,318000,344000,26000
1020594,6,12,344000,342000,-2000
1020594,7,45,342000,344000,2000
1020594,8,75,344000,369000,25000
1020594,9,53,369000,390000,21000
1020594,10,64,390000,414000,24000
1020594,11,70,414000,446000,32000
1020594,12,NA,446000,446000,0
1020594,13,75,446000,479000,33000
1020594,14,31,479000,481000,2000
1020594,15,37,481000,465000,-16000
1020594,16,54,465000,453000,-12000
1020594,17,39,453000,433000,-20000
1020594,18,19,433000,397000,-36000
1020594,19,33,397000,368000,-29000
1020594,20,50,368000,357000,-11000
1020594,21,40,357000,348000,-9000
1020594,22,78,348000,371000,23000
1020594,23,40,371000,386000,15000
1020594,24,59,386000,402000,16000
1020595,1,NA,200000,200000,0
1020595,2,NA,200000,200000,0
1020595,3,NA,200000,200000,0
1020595,4,NA,200000,200000,0
1020595,5,NA,200000,200000,0
1020595,6,NA,200000,200000,0
1020595,7,NA,200000,200000,0
1020595,8,NA,200000,200000,0
1020595,9,NA,200000,200000,0
1020595,10,NA,200000,200000,0
1020595,11,NA,200000,200000,0
1020595,12,NA,200000,200000,0
1020595,13,NA,200000,200000,0
1020595,14,NA,200000,200000,0
1020595,15,NA,200000,200000,0
1020595,16,NA,200000,200000,0
1020595,17,NA,200000,200000,0
1020595,18,NA,200000,200000,0
1020595,19,NA,200000,200000,0
1020595,20,NA,200000,200000,0
1020595,21,NA,200000,200000,0
1020595,22,NA,200000,200000,0
1020595,23,NA,200000,200000,0
1020595,24,NA,200000,200000,0
1020627,1,NA,200000,200000,0
1020627,2,NA,200000,200000,0
1020627,3,NA,200000,200000,0
1020627,4,NA,200000,200000,0
1020627,5,NA,200000,200000,0
1020627,6,NA,200000,200000,0
1020627,7,NA,200000,200000,0
1020627,8,NA,200000,200000,0
1020627,9,NA,200000,200000,0
1020627,10,NA,200000,200000,0
1020627,11,NA,200000,200000,0
1020627,12,NA,200000,200000,0
1020627,13,NA,200000,200000,0
1020627,14,NA,200000,200000,0
1020627,15,NA,200000,200000,0
1020627,16,NA,200000,200000,0
1020627,17,NA,200000,200000,0
1020627,18,NA,200000,200000,0
1020627,19,NA,200000,200000,0
1020627,20,NA,200000,200000,0
1020627,21,NA,200000,200000,0
1020627,22,NA,200000,200000,0
1020627,23,NA,200000,200000,0
1020627,24,NA,200000,200000,0
1020650,1,NA,260000,260000,0
1020650,2,NA,260000,260000,0
1020650,3,NA,260000,260000,0
1020650,4,NA,260000,260000,0
1020650,5,NA,260000,260000,0
1020650,6,NA,260000,260000,0
1020650,7,NA,260000,260000,0
1020650,8,NA,260000,260000,0
1020650,9,NA,260000,260000,0
1020650,10,NA,260000,260000,0
1020650,11,NA,260000,260000,0
1020650,12,NA,260000,260000,0
1020650,13,NA,260000,260000,0
1020650,14,NA,260000,260000,0
1020650,15,NA,260000,260000,0
1020650,16,NA,260000,260000,0
1020650,17,NA,260000,260000,0
1020650,18,NA,260000,260000,0
1020650,19,NA,260000,260000,0
1020650,20,NA,260000,260000,0
1020650,21,NA,260000,260000,0
1020650,22,NA,260000,260000,0
1020650,23,NA,260000,260000,0
1020650,24,NA,260000,260000,0
1020668,1,NA,200000,200000,0
1020668,2,NA,200000,200000,0
1020668,3,NA,200000,200000,0
1020668,4,NA,200000,200000,0
1020668,5,NA,200000,200000,0
1020668,6,NA,200000,200000,0
1020668,7,NA,200000,200000,0
1020668,8,NA,200000,200000,0
1020668,9,NA,200000,200000,0
1020668,10,NA,200000,200000,0
1020668,11,NA,200000,200000,0
1020668,12,NA,200000,200000,0
1020668,13,NA,200000,200000,0
1020668,14,NA,200000,200000,0
1020668,15,NA,200000,200000,0
1020668,16,NA,200000,200000,0
1020668,17,NA,200000,200000,0
1020668,18,NA,200000,200000,0
1020668,19,NA,200000,200000,0
1020668,20,NA,200000,200000,0
1020668,21,NA,200000,200000,0
1020668,22,NA,200000,200000,0
1020668,23,NA,200000,200000,0
1020668,24,NA,200000,200000,0
1020670,1,NA,274000,274000,0
1020670,2,4,274000,253000,-21000
1020670,3,55,253000,257000,4000
1020670,4,17,257000,251000,-6000
1020670,5,NA,251000,251000,0
1020670,6,NA,251000,251000,0
1020670,7,NA,251000,251000,0
1020670,8,NA,251000,251000,0
1020670,9,NA,251000,251000,0
1020670,10,NA,251000,251000,0
1020670,11,NA,251000,251000,0
1020670,12,11,251000,233000,-18000
1020670,13,NA,233000,233000,0
1020670,14,NA,233000,233000,0
1020670,15,47,233000,238000,5000
1020670,16,65,238000,269000,31000
1020670,17,62,269000,308000,39000
1020670,18,40,308000,336000,28000
1020670,19,60,336000,368000,32000
1020670,20,73,368000,405000,37000
1020670,21,45,405000,422000,17000
1020670,22,67,422000,442000,20000
1020670,23,61,442000,459000,17000
1020670,24,41,459000,456000,-3000
1020695,1,NA,220000,220000,0
1020695,2,NA,220000,220000,0
1020695,3,NA,220000,220000,0
1020695,4,NA,220000,220000,0
1020695,5,NA,220000,220000,0
1020695,6,NA,220000,220000,0
1020695,7,NA,220000,220000,0
1020695,8,NA,220000,220000,0
1020695,9,NA,220000,220000,0
1020695,10,NA,220000,220000,0
1020695,11,NA,220000,220000,0
1020695,12,NA,220000,220000,0
1020695,13,NA,220000,220000,0
1020695,14,NA,220000,220000,0
1020695,15,NA,220000,220000,0
1020695,16,NA,220000,220000,0
1020695,17,NA,220000,220000,0
1020695,18,NA,220000,220000,0
1020695,19,NA,220000,220000,0
1020695,20,NA,220000,220000,0
1020695,21,NA,220000,220000,0
1020695,22,NA,220000,220000,0
1020695,23,59,220000,243000,23000
1020695,24,84,243000,297000,54000
1020802,1,NA,490000,490000,0
1020802,2,NA,490000,490000,0
1020802,3,NA,490000,490000,0
1020802,4,46,490000,480000,-10000
1020802,5,54,480000,473000,-7000
1020802,6,71,473000,480000,7000
1020802,7,32,480000,467000,-13000
1020802,8,2,467000,422000,-45000
1020802,9,NA,422000,422000,0
1020802,10,NA,422000,422000,0
1020802,11,NA,422000,422000,0
1020802,12,NA,422000,422000,0
1020802,13,NA,422000,422000,0
1020802,14,NA,422000,422000,0
1020802,15,NA,422000,422000,0
1020802,16,NA,422000,422000,0
1020802,17,NA,422000,422000,0
1020802,18,NA,422000,422000,0
1020802,19,NA,422000,422000,0
1020802,20,NA,422000,422000,0
1020802,21,NA,422000,422000,0
1020802,22,NA,422000,422000,0
1020802,23,NA,422000,422000,0
1020802,24,NA,422000,422000,0
1020895,1,67,775000,759000,-16000
1020895,2,99,759000,755000,-4000
1020895,3,104,755000,765000,10000
1020895,4,64,765000,753000,-12000
1020895,5,119,753000,770000,17000
1020895,6,122,770000,806000,36000
1020895,7,81,806000,815000,9000
1020895,8,72,815000,804000,-11000
1020895,9,96,804000,798000,-6000
1020895,10,113,798000,803000,5000
1020895,11,100,803000,809000,6000
1020895,12,58,809000,788000,-21000
1020895,13,92,788000,775000,-13000
1020895,14,NA,775000,775000,0
1020895,15,90,775000,766000,-9000
1020895,16,87,766000,758000,-8000
1020895,17,85,758000,750000,-8000
1020895,18,92,750000,750000,0
1020895,19,93,750000,752000,2000
1020895,20,71,752000,742000,-10000
1020895,21,105,742000,747000,5000
1020895,22,159,747000,800000,53000
1020895,23,NA,800000,800000,0
1020895,24,84,800000,821000,21000
1020959,1,NA,200000,200000,0
1020959,2,NA,200000,200000,0
1020959,3,NA,200000,200000,0
1020959,4,NA,200000,200000,0
1020959,5,NA,200000,200000,0
1020959,6,NA,200000,200000,0
1020959,7,NA,200000,200000,0
1020959,8,41,200000,212000,12000
1020959,9,NA,212000,212000,0
1020959,10,NA,212000,212000,0
1020959,11,NA,212000,212000,0
1020959,12,NA,212000,212000,0
1020959,13,NA,212000,212000,0
1020959,14,NA,212000,212000,0
1020959,15,NA,212000,212000,0
1020959,16,NA,212000,212000,0
1020959,17,NA,212000,212000,0
1020959,18,NA,212000,212000,0
1020959,19,NA,212000,212000,0
1020959,20,NA,212000,212000,0
1020959,21,NA,212000,212000,0
1020959,22,NA,212000,212000,0
1020959,23,NA,212000,212000,0
1020959,24,53,212000,239000,27000
1020968,1,NA,313000,313000,0
1020968,2,NA,313000,313000,0
1020968,3,NA,313000,313000,0
1020968,4,NA,313000,313000,0
1020968,5,NA,313000,313000,0
1020968,6,NA,313000,313000,0
1020968,7,NA,313000,313000,0
1020968,8,NA,313000,313000,0
1020968,9,NA,313000,313000,0
1020968,10,NA,313000,313000,0
1020968,11,NA,313000,313000,0
1020968,12,NA,313000,313000,0
1020968,13,NA,313000,313000,0
1020968,14,NA,313000,313000,0
1020968,15,NA,313000,313000,0
1020968,16,NA,313000,313000,0
1020968,17,NA,313000,313000,0
1020968,18,35,313000,311000,-2000
1020968,19,29,311000,304000,-7000
1020968,20,17,304000,286000,-18000
1020968,21,52,286000,288000,2000
1020968,22,31,288000,287000,-1000
1020968,23,NA,287000,287000,0
1020968,24,NA,287000,287000,0
1020979,1,NA,200000,200000,0
1020979,2,NA,200000,200000,0
1020979,3,NA,200000,200000,0
1020979,4,NA,200000,200000,0
1020979,5,NA,200000,200000,0
1020979,6,NA,200000,200000,0
1020979,7,NA,200000,200000,0
1020979,8,NA,200000,200000,0
1020979,9,NA,200000,200000,0
1020979,10,NA,200000,200000,0
1020979,11,NA,200000,200000,0
1020979,12,NA,200000,200000,0
1020979,13,NA,200000,200000,0
1020979,14,NA,200000,200000,0
1020979,15,NA,200000,200000,0
1020979,16,NA,200000,200000,0
1020979,17,63,200000,228000,28000
1020979,18,48,228000,263000,35000
1020979,19,23,263000,280000,17000
1020979,20,NA,280000,280000,0
1020979,21,NA,280000,280000,0
1020979,22,NA,280000,280000,0
1020979,23,NA,280000,280000,0
1020979,24,NA,280000,280000,0
1021013,1,NA,200000,200000,0
1021013,2,NA,200000,200000,0
1021013,3,NA,200000,200000,0
1021013,4,74,200000,236000,36000
1021013,5,34,236000,268000,32000
1021013,6,NA,268000,268000,0
1021013,7,NA,268000,268000,0
1021013,8,NA,268000,268000,0
1021013,9,NA,268000,268000,0
1021013,10,NA,268000,268000,0
1021013,11,NA,268000,268000,0
1021013,12,NA,268000,268000,0
1021013,13,NA,268000,268000,0
1021013,14,NA,268000,268000,0
1021013,15,NA,268000,268000,0
1021013,16,NA,268000,268000,0
1021013,17,NA,268000,268000,0
1021013,18,NA,268000,268000,0
1021013,19,NA,268000,268000,0
1021013,20,NA,268000,268000,0
1021013,21,NA,268000,268000,0
1021013,22,NA,268000,268000,0
1021013,23,NA,268000,268000,0
1021013,24,NA,268000,268000,0
1021015,1,NA,200000,200000,0
1021015,2,NA,200000,200000,0
1021015,3,NA,200000,200000,0
1021015,4,NA,200000,200000,0
1021015,5,NA,200000,200000,0
1021015,6,NA,200000,200000,0
1021015,7,NA,200000,200000,0
1021015,8,NA,200000,200000,0
1021015,9,NA,200000,200000,0
1021015,10,NA,200000,200000,0
1021015,11,NA,200000,200000,0
1021015,12,NA,200000,200000,0
1021015,13,NA,200000,200000,0
1021015,14,NA,200000,200000,0
1021015,15,NA,200000,200000,0
1021015,16,NA,200000,200000,0
1021015,17,21,200000,200000,0
1021015,18,NA,200000,200000,0
1021015,19,NA,200000,200000,0
1021015,20,NA,200000,200000,0
1021015,21,NA,200000,200000,0
1021015,22,52,200000,216000,16000
1021015,23,22,216000,226000,10000
1021015,24,55,226000,251000,25000
1021031,1,NA,200000,200000,0
1021031,2,NA,200000,200000,0
1021031,3,NA,200000,200000,0
1021031,4,NA,200000,200000,0
1021031,5,NA,200000,200000,0
1021031,6,NA,200000,200000,0
1021031,7,NA,200000,200000,0
1021031,8,NA,200000,200000,0
1021031,9,NA,200000,200000,0
1021031,10,NA,200000,200000,0
1021031,11,NA,200000,200000,0
1021031,12,NA,200000,200000,0
1021031,13,NA,200000,200000,0
1021031,14,NA,200000,200000,0
1021031,15,NA,200000,200000,0
1021031,16,NA,200000,200000,0
1021031,17,NA,200000,200000,0
1021031,18,NA,200000,200000,0
1021031,19,67,200000,230000,30000
1021031,20,59,230000,275000,45000
1021031,21,58,275000,322000,47000
1021031,22,63,322000,368000,46000
1021031,23,NA,368000,368000,0
1021031,24,NA,368000,368000,0
1021090,1,NA,200000,200000,0
1021090,2,6,200000,200000,0
1021090,3,NA,200000,200000,0
1021090,4,NA,200000,200000,0
1021090,5,NA,200000,200000,0
1021090,6,NA,200000,200000,0
1021090,7,NA,200000,200000,0
1021090,8,NA,200000,200000,0
1021090,9,NA,200000,200000,0
1021090,10,NA,200000,200000,0
1021090,11,NA,200000,200000,0
1021090,12,NA,200000,200000,0
1021090,13,NA,200000,200000,0
1021090,14,NA,200000,200000,0
1021090,15,NA,200000,200000,0
1021090,16,NA,200000,200000,0
1021090,17,NA,200000,200000,0
1021090,18,NA,200000,200000,0
1021090,19,NA,200000,200000,0
1021090,20,NA,200000,200000,0
1021090,21,NA,200000,200000,0
1021090,22,NA,200000,200000,0
1021090,23,NA,200000,200000,0
1021090,24,NA,200000,200000,0
1021103,1,NA,303000,303000,0
1021103,2,NA,303000,303000,0
1021103,3,NA,303000,303000,0
1021103,4,NA,303000,303000,0
1021103,5,NA,303000,303000,0
1021103,6,15,303000,288000,-15000
1021103,7,47,288000,286000,-2000
1021103,8,56,286000,302000,16000
1021103,9,70,302000,337000,35000
1021103,10,57,337000,372000,35000
1021103,11,33,372000,387000,15000
1021103,12,91,387000,424000,37000
1021103,13,NA,424000,424000,0
1021103,14,NA,424000,424000,0
1021103,15,NA,424000,424000,0
1021103,16,NA,424000,424000,0
1021103,17,NA,424000,424000,0
1021103,18,NA,424000,424000,0
1021103,19,NA,424000,424000,0
1021103,20,NA,424000,424000,0
1021103,21,NA,424000,424000,0
1021103,22,NA,424000,424000,0
1021103,23,NA,424000,424000,0
1021103,24,41,424000,436000,12000
1021108,1,19,292000,281000,-11000
1021108,2,NA,281000,281000,0
1021108,3,NA,281000,281000,0
1021108,4,NA,281000,281000,0
1021108,5,NA,281000,281000,0
1021108,6,NA,281000,281000,0
1021108,7,NA,281000,281000,0
1021108,8,NA,281000,281000,0
1021108,9,NA,281000,281000,0
1021108,10,NA,281000,281000,0
1021108,11,NA,281000,281000,0
1021108,12,NA,281000,281000,0
1021108,13,NA,281000,281000,0
1021108,14,NA,281000,281000,0
1021108,15,NA,281000,281000,0
1021108,16,NA,281000,281000,0
1021108,17,NA,281000,281000,0
1021108,18,NA,281000,281000,0
1021108,19,NA,281000,281000,0
1021108,20,13,281000,259000,-22000
1021108,21,NA,259000,259000,0
1021108,22,NA,259000,259000,0
1021108,23,NA,259000,259000,0
1021108,24,NA,259000,259000,0
1021122,1,NA,270000,270000,0
1021122,2,19,270000,261000,-9000
1021122,3,56,261000,273000,12000
1021122,4,27,273000,278000,5000
1021122,5,31,278000,280000,2000
1021122,6,33,280000,282000,2000
1021122,7,25,282000,277000,-5000
1021122,8,NA,277000,277000,0
1021122,9,NA,277000,277000,0
1021122,10,NA,277000,277000,0
1021122,11,NA,277000,277000,0
1021122,12,NA,277000,277000,0
1021122,13,15,277000,258000,-19000
1021122,14,NA,258000,258000,0
1021122,15,NA,258000,258000,0
1021122,16,NA,258000,258000,0
1021122,17,NA,258000,258000,0
1021122,18,NA,258000,258000,0
1021122,19,NA,258000,258000,0
1021122,20,NA,258000,258000,0
1021122,21,NA,258000,258000,0
1021122,22,NA,258000,258000,0
1021122,23,NA,258000,258000,0
1021122,24,NA,258000,258000,0
1021152,1,NA,200000,200000,0
1021152,2,NA,200000,200000,0
1021152,3,NA,200000,200000,0
1021152,4,NA,200000,200000,0
1021152,5,NA,200000,200000,0
1021152,6,NA,200000,200000,0
1021152,7,NA,200000,200000,0
1021152,8,NA,200000,200000,0
1021152,9,NA,200000,200000,0
1021152,10,NA,200000,200000,0
1021152,11,NA,200000,200000,0
1021152,12,NA,200000,200000,0
1021152,13,NA,200000,200000,0
1021152,14,NA,200000,200000,0
1021152,15,NA,200000,200000,0
1021152,16,NA,200000,200000,0
1021152,17,6,200000,200000,0
1021152,18,NA,200000,200000,0
1021152,19,NA,200000,200000,0
1021152,20,NA,200000,200000,0
1021152,21,21,200000,200000,0
1021152,22,46,200000,200000,0
1021152,23,NA,200000,200000,0
1021152,24,22,200000,200000,0
1021200,1,NA,200000,200000,0
1021200,2,NA,200000,200000,0
1021200,3,NA,200000,200000,0
1021200,4,NA,200000,200000,0
1021200,5,NA,200000,200000,0
1021200,6,NA,200000,200000,0
1021200,7,NA,200000,200000,0
1021200,8,NA,200000,200000,0
1021200,9,NA,200000,200000,0
1021200,10,66,200000,230000,30000
1021200,11,18,230000,245000,15000
1021200,12,NA,245000,245000,0
1021200,13,NA,245000,245000,0
1021200,14,NA,245000,245000,0
1021200,15,NA,245000,245000,0
1021200,16,NA,245000,245000,0
1021200,17,NA,245000,245000,0
1021200,18,NA,245000,245000,0
1021200,19,NA,245000,245000,0
1021200,20,NA,245000,245000,0
1021200,21,NA,245000,245000,0
1021200,22,NA,245000,245000,0
1021200,23,NA,245000,245000,0
1021200,24,NA,245000,245000,0
1021276,1,NA,200000,200000,0
1021276,2,NA,200000,200000,0
1021276,3,NA,200000,200000,0
1021276,4,NA,200000,200000,0
1021276,5,NA,200000,200000,0
1021276,6,NA,200000,200000,0
1021276,7,NA,200000,200000,0
1021276,8,NA,200000,200000,0
1021276,9,NA,200000,200000,0
1021276,10,NA,200000,200000,0
1021276,11,NA,200000,200000,0
1021276,12,NA,200000,200000,0
1021276,13,NA,200000,200000,0
1021276,14,NA,200000,200000,0
1021276,15,NA,200000,200000,0
1021276,16,NA,200000,200000,0
1021276,17,NA,200000,200000,0
1021276,18,NA,200000,200000,0
1021276,19,NA,200000,200000,0
1021276,20,NA,200000,200000,0
1021276,21,NA,200000,200000,0
1021276,22,NA,200000,200000,0
1021276,23,NA,200000,200000,0
1021276,24,NA,200000,200000,0
1021296,1,NA,230000,230000,0
1021296,2,NA,230000,230000,0
1021296,3,NA,230000,230000,0
1021296,4,NA,230000,230000,0
1021296,5,NA,230000,230000,0
1021296,6,NA,230000,230000,0
1021296,7,NA,230000,230000,0
1021296,8,NA,230000,230000,0
1021296,9,NA,230000,230000,0
1021296,10,NA,230000,230000,0
1021296,11,NA,230000,230000,0
1021296,12,NA,230000,230000,0
1021296,13,NA,230000,230000,0
1021296,14,NA,230000,230000,0
1021296,15,NA,230000,230000,0
1021296,16,NA,230000,230000,0
1021296,17,NA,230000,230000,0
1021296,18,NA,230000,230000,0
1021296,19,NA,230000,230000,0
1021296,20,NA,230000,230000,0
1021296,21,NA,230000,230000,0
1021296,22,NA,230000,230000,0
1021296,23,NA,230000,230000,0
1021296,24,NA,230000,230000,0
1021306,1,NA,200000,200000,0
1021306,2,NA,200000,200000,0
1021306,3,NA,200000,200000,0
1021306,4,NA,200000,200000,0
1021306,5,NA,200000,200000,0
1021306,6,NA,200000,200000,0
1021306,7,NA,200000,200000,0
1021306,8,NA,200000,200000,0
1021306,9,NA,200000,200000,0
1021306,10,NA,200000,200000,0
1021306,11,NA,200000,200000,0
1021306,12,NA,200000,200000,0
1021306,13,NA,200000,200000,0
1021306,14,NA,200000,200000,0
1021306,15,NA,200000,200000,0
1021306,16,NA,200000,200000,0
1021306,17,NA,200000,200000,0
1021306,18,NA,200000,200000,0
1021306,19,NA,200000,200000,0
1021306,20,NA,200000,200000,0
1021306,21,NA,200000,200000,0
1021306,22,NA,200000,200000,0
1021306,23,NA,200000,200000,0
1021306,24,NA,200000,200000,0
1021353,1,35,242000,247000,5000
1021353,2,40,247000,260000,13000
1021353,3,45,260000,279000,19000
1021353,4,42,279000,297000,18000
1021353,5,39,297000,311000,14000
1021353,6,48,311000,327000,16000
1021353,7,NA,327000,327000,0
1021353,8,NA,327000,327000,0
1021353,9,NA,327000,327000,0
1021353,10,NA,327000,327000,0
1021353,11,NA,327000,327000,0
1021353,12,NA,327000,327000,0
1021353,13,NA,327000,327000,0
1021353,14,NA,327000,327000,0
1021353,15,NA,327000,327000,0
1021353,16,NA,327000,327000,0
1021353,17,NA,327000,327000,0
1021353,18,NA,327000,327000,0
1021353,19,35,327000,331000,4000
1021353,20,NA,331000,331000,0
1021353,21,NA,331000,331000,0
1021353,22,NA,331000,331000,0
1021353,23,NA,331000,331000,0
1021353,24,NA,331000,331000,0
1021660,1,NA,200000,200000,0
1021660,2,NA,200000,200000,0
1021660,3,NA,200000,200000,0
1021660,4,NA,200000,200000,0
1021660,5,NA,200000,200000,0
1021660,6,NA,200000,200000,0
1021660,7,NA,200000,200000,0
1021660,8,NA,200000,200000,0
1021660,9,NA,200000,200000,0
1021660,10,NA,200000,200000,0
1021660,11,NA,200000,200000,0
1021660,12,NA,200000,200000,0
1021660,13,NA,200000,200000,0
1021660,14,NA,200000,200000,0
1021660,15,NA,200000,200000,0
1021660,16,NA,200000,200000,0
1021660,17,NA,200000,200000,0
1021660,18,NA,200000,200000,0
1021660,19,NA,200000,200000,0
1021660,20,NA,200000,200000,0
1021660,21,NA,200000,200000,0
1021660,22,NA,200000,200000,0
1021660,23,NA,200000,200000,0
1021660,24,NA,200000,200000,0
1022844,1,NA,200000,200000,0
1022844,2,NA,200000,200000,0
1022844,3,NA,200000,200000,0
1022844,4,NA,200000,200000,0
1022844,5,NA,200000,200000,0
1022844,6,NA,200000,200000,0
1022844,7,NA,200000,200000,0
1022844,8,NA,200000,200000,0
1022844,9,NA,200000,200000,0
1022844,10,NA,200000,200000,0
1022844,11,NA,200000,200000,0
1022844,12,NA,200000,200000,0
1022844,13,NA,200000,200000,0
1022844,14,NA,200000,200000,0
1022844,15,NA,200000,200000,0
1022844,16,NA,200000,200000,0
1022844,17,NA,200000,200000,0
1022844,18,NA,200000,200000,0
1022844,19,NA,200000,200000,0
1022844,20,NA,200000,200000,0
1022844,21,NA,200000,200000,0
1022844,22,NA,200000,200000,0
1022844,23,NA,200000,200000,0
1022844,24,NA,200000,200000,0
1022889,1,NA,200000,200000,0
1022889,2,NA,200000,200000,0
1022889,3,NA,200000,200000,0
1022889,4,NA,200000,200000,0
1022889,5,NA,200000,200000,0
1022889,6,NA,200000,200000,0
1022889,7,NA,200000,200000,0
1022889,8,NA,200000,200000,0
1022889,9,NA,200000,200000,0
1022889,10,NA,200000,200000,0
1022889,11,NA,200000,200000,0
1022889,12,NA,200000,200000,0
1022889,13,NA,200000,200000,0
1022889,14,NA,200000,200000,0
1022889,15,NA,200000,200000,0
1022889,16,NA,200000,200000,0
1022889,17,NA,200000,200000,0
1022889,18,NA,200000,200000,0
1022889,19,NA,200000,200000,0
1022889,20,NA,200000,200000,0
1022889,21,NA,200000,200000,0
1022889,22,NA,200000,200000,0
1022889,23,NA,200000,200000,0
1022889,24,NA,200000,200000,0
1022915,1,NA,264000,264000,0
1022915,2,NA,264000,264000,0
1022915,3,NA,264000,264000,0
1022915,4,NA,264000,264000,0
1022915,5,NA,264000,264000,0
1022915,6,NA,264000,264000,0
1022915,7,NA,264000,264000,0
1022915,8,NA,264000,264000,0
1022915,9,NA,264000,264000,0
1022915,10,NA,264000,264000,0
1022915,11,NA,264000,264000,0
1022915,12,NA,264000,264000,0
1022915,13,NA,264000,264000,0
1022915,14,NA,264000,264000,0
1022915,15,NA,264000,264000,0
1022915,16,NA,264000,264000,0
1022915,17,NA,264000,264000,0
1022915,18,NA,264000,264000,0
1022915,19,NA,264000,264000,0
1022915,20,NA,264000,264000,0
1022915,21,NA,264000,264000,0
1022915,22,NA,264000,264000,0
1022915,23,NA,264000,264000,0
1022915,24,NA,264000,264000,0
1022927,1,NA,236000,236000,0
1022927,2,NA,236000,236000,0
1022927,3,NA,236000,236000,0
1022927,4,NA,236000,236000,0
1022927,5,NA,236000,236000,0
1022927,6,NA,236000,236000,0
1022927,7,NA,236000,236000,0
1022927,8,NA,236000,236000,0
1022927,9,NA,236000,236000,0
1022927,10,NA,236000,236000,0
1022927,11,NA,236000,236000,0
1022927,12,NA,236000,236000,0
1022927,13,NA,236000,236000,0
1022927,14,NA,236000,236000,0
1022927,15,NA,236000,236000,0
1022927,16,NA,236000,236000,0
1022927,17,NA,236000,236000,0
1022927,18,NA,236000,236000,0
1022927,19,NA,236000,236000,0
1022927,20,NA,236000,236000,0
1022927,21,NA,236000,236000,0
1022927,22,NA,236000,236000,0
1022927,23,NA,236000,236000,0
1022927,24,NA,236000,236000,0
1022999,1,NA,204000,204000,0
1022999,2,NA,204000,204000,0
1022999,3,NA,204000,204000,0
1022999,4,NA,204000,204000,0
1022999,5,NA,204000,204000,0
1022999,6,NA,204000,204000,0
1022999,7,NA,204000,204000,0
1022999,8,NA,204000,204000,0
1022999,9,NA,204000,204000,0
1022999,10,NA,204000,204000,0
1022999,11,NA,204000,204000,0
1022999,12,NA,204000,204000,0
1022999,13,NA,204000,204000,0
1022999,14,NA,204000,204000,0
1022999,15,NA,204000,204000,0
1022999,16,NA,204000,204000,0
1022999,17,NA,204000,204000,0
1022999,18,NA,204000,204000,0
1022999,19,NA,204000,204000,0
1022999,20,NA,204000,204000,0
1022999,21,NA,204000,204000,0
1022999,22,NA,204000,204000,0
1022999,23,NA,204000,204000,0
1022999,24,NA,204000,204000,0
1023017,1,NA,276000,276000,0
1023017,2,NA,276000,276000,0
1023017,3,NA,276000,276000,0
1023017,4,NA,276000,276000,0
1023017,5,NA,276000,276000,0
1023017,6,NA,276000,276000,0
1023017,7,NA,276000,276000,0
1023017,8,NA,276000,276000,0
1023017,9,NA,276000,276000,0
1023017,10,NA,276000,276000,0
1023017,11,NA,276000,276000,0
1023017,12,NA,276000,276000,0
1023017,13,NA,276000,276000,0
1023017,14,NA,276000,276000,0
1023017,15,NA,276000,276000,0
1023017,16,NA,276000,276000,0
1023017,17,NA,276000,276000,0
1023017,18,NA,276000,276000,0
1023017,19,NA,276000,276000,0
1023017,20,NA,276000,276000,0
1023017,21,NA,276000,276000,0
1023017,22,NA,276000,276000,0
1023017,23,NA,276000,276000,0
1023017,24,NA,276000,276000,0
1023025,1,92,284000,328000,44000
1023025,2,71,328000,384000,56000
1023025,3,82,384000,448000,64000
1023025,4,48,448000,482000,34000
1023025,5,43,482000,489000,7000
1023025,6,62,489000,490000,1000
1023025,7,50,490000,482000,-8000
1023025,8,60,482000,478000,-4000
1023025,9,96,478000,506000,28000
1023025,10,24,506000,499000,-7000
1023025,11,67,499000,499000,0
1023025,12,58,499000,498000,-1000
1023025,13,71,498000,504000,6000
1023025,14,NA,504000,504000,0
1023025,15,59,504000,508000,4000
1023025,16,53,508000,508000,0
1023025,17,34,508000,488000,-20000
1023025,18,15,488000,445000,-43000
1023025,19,NA,445000,445000,0
1023025,20,NA,445000,445000,0
1023025,21,NA,445000,445000,0
1023025,22,NA,445000,445000,0
1023025,23,NA,445000,445000,0
1023025,24,NA,445000,445000,0
1023056,1,NA,200000,200000,0
1023056,2,NA,200000,200000,0
1023056,3,NA,200000,200000,0
1023056,4,NA,200000,200000,0
1023056,5,NA,200000,200000,0
1023056,6,NA,200000,200000,0
1023056,7,NA,200000,200000,0
1023056,8,NA,200000,200000,0
1023056,9,NA,200000,200000,0
1023056,10,NA,200000,200000,0
1023056,11,NA,200000,200000,0
1023056,12,NA,200000,200000,0
1023056,13,NA,200000,200000,0
1023056,14,NA,200000,200000,0
1023056,15,NA,200000,200000,0
1023056,16,NA,200000,200000,0
1023056,17,NA,200000,200000,0
1023056,18,NA,200000,200000,0
1023056,19,NA,200000,200000,0
1023056,20,NA,200000,200000,0
1023056,21,NA,200000,200000,0
1023056,22,NA,200000,200000,0
1023056,23,NA,200000,200000,0
1023056,24,NA,200000,200000,0
1023142,1,NA,200000,200000,0
1023142,2,NA,200000,200000,0
1023142,3,NA,200000,200000,0
1023142,4,NA,200000,200000,0
1023142,5,NA,200000,200000,0
1023142,6,NA,200000,200000,0
1023142,7,NA,200000,200000,0
1023142,8,NA,200000,200000,0
1023142,9,NA,200000,200000,0
1023142,10,NA,200000,200000,0
1023142,11,NA,200000,200000,0
1023142,12,NA,200000,200000,0
1023142,13,NA,200000,200000,0
1023142,14,NA,200000,200000,0
1023142,15,NA,200000,200000,0
1023142,16,NA,200000,200000,0
1023142,17,NA,200000,200000,0
1023142,18,NA,200000,200000,0
1023142,19,NA,200000,200000,0
1023142,20,NA,200000,200000,0
1023142,21,NA,200000,200000,0
1023142,22,NA,200000,200000,0
1023142,23,NA,200000,200000,0
1023142,24,NA,200000,200000,0
1023144,1,NA,200000,200000,0
1023144,2,NA,200000,200000,0
1023144,3,NA,200000,200000,0
1023144,4,NA,200000,200000,0
1023144,5,NA,200000,200000,0
1023144,6,NA,200000,200000,0
1023144,7,NA,200000,200000,0
1023144,8,NA,200000,200000,0
1023144,9,NA,200000,200000,0
1023144,10,NA,200000,200000,0
1023144,11,NA,200000,200000,0
1023144,12,NA,200000,200000,0
1023144,13,NA,200000,200000,0
1023144,14,NA,200000,200000,0
1023144,15,NA,200000,200000,0
1023144,16,NA,200000,200000,0
1023144,17,NA,200000,200000,0
1023144,18,NA,200000,200000,0
1023144,19,NA,200000,200000,0
1023144,20,18,200000,200000,0
1023144,21,20,200000,200000,0
1023144,22,NA,200000,200000,0
1023144,23,NA,200000,200000,0
1023144,24,NA,200000,200000,0
1023167,1,NA,450000,450000,0
1023167,2,NA,450000,450000,0
1023167,3,NA,450000,450000,0
1023167,4,19,450000,424000,-26000
1023167,5,41,424000,400000,-24000
1023167,6,NA,400000,400000,0
1023167,7,NA,400000,400000,0
1023167,8,NA,400000,400000,0
1023167,9,50,400000,386000,-14000
1023167,10,44,386000,378000,-8000
1023167,11,67,378000,391000,13000
1023167,12,71,391000,419000,28000
1023167,13,60,419000,444000,25000
1023167,14,NA,444000,444000,0
1023167,15,52,444000,459000,15000
1023167,16,46,459000,462000,3000
1023167,17,111,462000,500000,38000
1023167,18,71,500000,530000,30000
1023167,19,76,530000,558000,28000
1023167,20,56,558000,568000,10000
1023167,21,53,568000,563000,-5000
1023167,22,NA,563000,563000,0
1023167,23,NA,563000,563000,0
1023167,24,105,563000,578000,15000
1023174,1,NA,228000,228000,0
1023174,2,NA,228000,228000,0
1023174,3,NA,228000,228000,0
1023174,4,NA,228000,228000,0
1023174,5,NA,228000,228000,0
1023174,6,NA,228000,228000,0
1023174,7,NA,228000,228000,0
1023174,8,NA,228000,228000,0
1023174,9,NA,228000,228000,0
1023174,10,NA,228000,228000,0
1023174,11,NA,228000,228000,0
1023174,12,NA,228000,228000,0
1023174,13,NA,228000,228000,0
1023174,14,NA,228000,228000,0
1023174,15,NA,228000,228000,0
1023174,16,NA,228000,228000,0
1023174,17,NA,228000,228000,0
1023174,18,NA,228000,228000,0
1023174,19,NA,228000,228000,0
1023174,20,NA,228000,228000,0
1023174,21,NA,228000,228000,0
1023174,22,NA,228000,228000,0
1023174,23,NA,228000,228000,0
1023174,24,NA,228000,228000,0
1023261,1,114,769000,788000,19000
1023261,2,117,788000,821000,33000
1023261,3,100,821000,846000,25000
1023261,4,126,846000,879000,33000
1023261,5,136,879000,923000,44000
1023261,6,140,923000,971000,48000
1023261,7,99,971000,987000,16000
1023261,8,84,987000,973000,-14000
1023261,9,115,973000,960000,-13000
1023261,10,79,960000,923000,-37000
1023261,11,116,923000,905000,-18000
1023261,12,114,905000,901000,-4000
1023261,13,101,901000,897000,-4000
1023261,14,NA,897000,897000,0
1023261,15,120,897000,908000,11000
1023261,16,150,908000,948000,40000
1023261,17,112,948000,970000,22000
1023261,18,132,970000,995000,25000
1023261,19,86,995000,987000,-8000
1023261,20,97,987000,965000,-22000
1023261,21,37,965000,894000,-71000
1023261,22,NA,894000,894000,0
1023261,23,NA,894000,894000,0
1023261,24,NA,894000,894000,0
1023266,1,83,406000,433000,27000
1023266,2,61,433000,460000,27000
1023266,3,48,460000,474000,14000
1023266,4,88,474000,504000,30000
1023266,5,61,504000,523000,19000
1023266,6,67,523000,536000,13000
1023266,7,98,536000,568000,32000
1023266,8,70,568000,591000,23000
1023266,9,91,591000,617000,26000
1023266,10,66,617000,627000,10000
1023266,11,75,627000,633000,6000
1023266,12,85,633000,639000,6000
1023266,13,71,639000,640000,1000
1023266,14,108,640000,666000,26000
1023266,15,NA,666000,666000,0
1023266,16,82,666000,684000,18000
1023266,17,74,684000,689000,5000
1023266,18,NA,689000,689000,0
1023266,19,67,689000,681000,-8000
1023266,20,70,681000,667000,-14000
1023266,21,NA,667000,667000,0
1023266,22,NA,667000,667000,0
1023266,23,NA,667000,667000,0
1023266,24,NA,667000,667000,0
1023270,1,NA,448000,448000,0
1023270,2,16,448000,421000,-27000
1023270,3,59,421000,409000,-12000
1023270,4,58,409000,409000,0
1023270,5,38,409000,404000,-5000
1023270,6,15,404000,380000,-24000
1023270,7,20,380000,348000,-32000
1023270,8,NA,348000,348000,0
1023270,9,NA,348000,348000,0
1023270,10,NA,348000,348000,0
1023270,11,NA,348000,348000,0
1023270,12,NA,348000,348000,0
1023270,13,66,348000,344000,-4000
1023270,14,85,344000,375000,31000
1023270,15,42,375000,395000,20000
1023270,16,77,395000,433000,38000
1023270,17,74,433000,472000,39000
1023270,18,100,472000,522000,50000
1023270,19,114,522000,587000,65000
1023270,20,70,587000,628000,41000
1023270,21,64,628000,642000,14000
1023270,22,65,642000,638000,-4000
1023270,23,95,638000,644000,6000
1023270,24,80,644000,645000,1000
1023272,1,77,426000,447000,21000
1023272,2,90,447000,490000,43000
1023272,3,65,490000,524000,34000
1023272,4,115,524000,583000,59000
1023272,5,77,583000,624000,41000
1023272,6,99,624000,665000,41000
1023272,7,70,665000,680000,15000
1023272,8,100,680000,702000,22000
1023272,9,51,702000,688000,-14000
1023272,10,36,688000,646000,-42000
1023272,11,NA,646000,646000,0
1023272,12,NA,646000,646000,0
1023272,13,107,646000,639000,-7000
1023272,14,54,639000,624000,-15000
1023272,15,68,624000,610000,-14000
1023272,16,75,610000,608000,-2000
1023272,17,59,608000,599000,-9000
1023272,18,66,599000,587000,-12000
1023272,19,82,587000,591000,4000
1023272,20,52,591000,581000,-10000
1023272,21,69,581000,575000,-6000
1023272,22,84,575000,583000,8000
1023272,23,56,583000,578000,-5000
1023272,24,73,578000,576000,-2000
1023273,1,NA,200000,200000,0
1023273,2,NA,200000,200000,0
1023273,3,NA,200000,200000,0
1023273,4,NA,200000,200000,0
1023273,5,NA,200000,200000,0
1023273,6,NA,200000,200000,0
1023273,7,NA,200000,200000,0
1023273,8,NA,200000,200000,0
1023273,9,NA,200000,200000,0
1023273,10,NA,200000,200000,0
1023273,11,NA,200000,200000,0
1023273,12,NA,200000,200000,0
1023273,13,NA,200000,200000,0
1023273,14,NA,200000,200000,0
1023273,15,NA,200000,200000,0
1023273,16,NA,200000,200000,0
1023273,17,NA,200000,200000,0
1023273,18,NA,200000,200000,0
1023273,19,NA,200000,200000,0
1023273,20,NA,200000,200000,0
1023273,21,NA,200000,200000,0
1023273,22,NA,200000,200000,0
1023273,23,NA,200000,200000,0
1023273,24,NA,200000,200000,0
1023274,1,NA,200000,200000,0
1023274,2,NA,200000,200000,0
1023274,3,NA,200000,200000,0
1023274,4,NA,200000,200000,0
1023274,5,NA,200000,200000,0
1023274,6,NA,200000,200000,0
1023274,7,NA,200000,200000,0
1023274,8,NA,200000,200000,0
1023274,9,NA,200000,200000,0
1023274,10,NA,200000,200000,0
1023274,11,NA,200000,200000,0
1023274,12,NA,200000,200000,0
1023274,13,NA,200000,200000,0
1023274,14,NA,200000,200000,0
1023274,15,NA,200000,200000,0
1023274,16,NA,200000,200000,0
1023274,17,NA,200000,200000,0
1023274,18,NA,200000,200000,0
1023274,19,NA,200000,200000,0
1023274,20,NA,200000,200000,0
1023274,21,NA,200000,200000,0
1023274,22,NA,200000,200000,0
1023274,23,NA,200000,200000,0
1023274,24,NA,200000,200000,0
1023275,1,NA,200000,200000,0
1023275,2,NA,200000,200000,0
1023275,3,NA,200000,200000,0
1023275,4,NA,200000,200000,0
1023275,5,NA,200000,200000,0
1023275,6,NA,200000,200000,0
1023275,7,NA,200000,200000,0
1023275,8,NA,200000,200000,0
1023275,9,NA,200000,200000,0
1023275,10,NA,200000,200000,0
1023275,11,NA,200000,200000,0
1023275,12,NA,200000,200000,0
1023275,13,NA,200000,200000,0
1023275,14,NA,200000,200000,0
1023275,15,NA,200000,200000,0
1023275,16,NA,200000,200000,0
1023275,17,NA,200000,200000,0
1023275,18,NA,200000,200000,0
1023275,19,NA,200000,200000,0
1023275,20,NA,200000,200000,0
1023275,21,NA,200000,200000,0
1023275,22,NA,200000,200000,0
1023275,23,NA,200000,200000,0
1023275,24,NA,200000,200000,0
1023346,1,NA,200000,200000,0
1023346,2,NA,200000,200000,0
1023346,3,NA,200000,200000,0
1023346,4,NA,200000,200000,0
1023346,5,NA,200000,200000,0
1023346,6,NA,200000,200000,0
1023346,7,NA,200000,200000,0
1023346,8,NA,200000,200000,0
1023346,9,NA,200000,200000,0
1023346,10,NA,200000,200000,0
1023346,11,NA,200000,200000,0
1023346,12,NA,200000,200000,0
1023346,13,NA,200000,200000,0
1023346,14,NA,200000,200000,0
1023346,15,NA,200000,200000,0
1023346,16,NA,200000,200000,0
1023346,17,NA,200000,200000,0
1023346,18,NA,200000,200000,0
1023346,19,NA,200000,200000,0
1023346,20,NA,200000,200000,0
1023346,21,NA,200000,200000,0
1023346,22,NA,200000,200000,0
1023346,23,NA,200000,200000,0
1023346,24,NA,200000,200000,0
1023446,1,NA,200000,200000,0
1023446,2,NA,200000,200000,0
1023446,3,NA,200000,200000,0
1023446,4,NA,200000,200000,0
1023446,5,NA,200000,200000,0
1023446,6,NA,200000,200000,0
1023446,7,NA,200000,200000,0
1023446,8,NA,200000,200000,0
1023446,9,NA,200000,200000,0
1023446,10,NA,200000,200000,0
1023446,11,NA,200000,200000,0
1023446,12,NA,200000,200000,0
1023446,13,NA,200000,200000,0
1023446,14,NA,200000,200000,0
1023446,15,NA,200000,200000,0
1023446,16,NA,200000,200000,0
1023446,17,NA,200000,200000,0
1023446,18,NA,200000,200000,0
1023446,19,NA,200000,200000,0
1023446,20,NA,200000,200000,0
1023446,21,NA,200000,200000,0
1023446,22,NA,200000,200000,0
1023446,23,NA,200000,200000,0
1023446,24,NA,200000,200000,0
1023464,1,NA,200000,200000,0
1023464,2,NA,200000,200000,0
1023464,3,NA,200000,200000,0
1023464,4,NA,200000,200000,0
1023464,5,NA,200000,200000,0
1023464,6,NA,200000,200000,0
1023464,7,NA,200000,200000,0
1023464,8,NA,200000,200000,0
1023464,9,NA,200000,200000,0
1023464,10,NA,200000,200000,0
1023464,11,NA,200000,200000,0
1023464,12,NA,200000,200000,0
1023464,13,NA,200000,200000,0
1023464,14,NA,200000,200000,0
1023464,15,NA,200000,200000,0
1023464,16,NA,200000,200000,0
1023464,17,NA,200000,200000,0
1023464,18,NA,200000,200000,0
1023464,19,NA,200000,200000,0
1023464,20,NA,200000,200000,0
1023464,21,NA,200000,200000,0
1023464,22,NA,200000,200000,0
1023464,23,NA,200000,200000,0
1023464,24,NA,200000,200000,0
1023475,1,NA,200000,200000,0
1023475,2,NA,200000,200000,0
1023475,3,NA,200000,200000,0
1023475,4,NA,200000,200000,0
1023475,5,NA,200000,200000,0
1023475,6,NA,200000,200000,0
1023475,7,NA,200000,200000,0
1023475,8,53,200000,221000,21000
1023475,9,25,221000,235000,14000
1023475,10,14,235000,234000,-1000
1023475,11,NA,234000,234000,0
1023475,12,NA,234000,234000,0
1023475,13,NA,234000,234000,0
1023475,14,NA,234000,234000,0
1023475,15,NA,234000,234000,0
1023475,16,NA,234000,234000,0
1023475,17,NA,234000,234000,0
1023475,18,NA,234000,234000,0
1023475,19,NA,234000,234000,0
1023475,20,NA,234000,234000,0
1023475,21,NA,234000,234000,0
1023475,22,NA,234000,234000,0
1023475,23,13,234000,222000,-12000
1023475,24,NA,222000,222000,0
1023477,1,NA,294000,294000,0
1023477,2,NA,294000,294000,0
1023477,3,NA,294000,294000,0
1023477,4,NA,294000,294000,0
1023477,5,NA,294000,294000,0
1023477,6,NA,294000,294000,0
1023477,7,NA,294000,294000,0
1023477,8,NA,294000,294000,0
1023477,9,NA,294000,294000,0
1023477,10,82,294000,327000,33000
1023477,11,51,327000,360000,33000
1023477,12,62,360000,395000,35000
1023477,13,97,395000,450000,55000
1023477,14,31,450000,469000,19000
1023477,15,NA,469000,469000,0
1023477,16,86,469000,496000,27000
1023477,17,NA,496000,496000,0
1023477,18,32,496000,492000,-4000
1023477,19,NA,492000,492000,0
1023477,20,NA,492000,492000,0
1023477,21,NA,492000,492000,0
1023477,22,79,492000,501000,9000
1023477,23,NA,501000,501000,0
1023477,24,NA,501000,501000,0
1023482,1,75,288000,319000,31000
1023482,2,44,319000,347000,28000
1023482,3,94,347000,404000,57000
1023482,4,56,404000,444000,40000
1023482,5,20,444000,444000,0
1023482,6,45,444000,434000,-10000
1023482,7,NA,434000,434000,0
1023482,8,NA,434000,434000,0
1023482,9,58,434000,430000,-4000
1023482,10,94,430000,454000,24000
1023482,11,31,454000,456000,2000
1023482,12,50,456000,456000,0
1023482,13,35,456000,442000,-14000
1023482,14,NA,442000,442000,0
1023482,15,43,442000,425000,-17000
1023482,16,NA,425000,425000,0
1023482,17,NA,425000,425000,0
1023482,18,NA,425000,425000,0
1023482,19,NA,425000,425000,0
1023482,20,24,425000,393000,-32000
1023482,21,12,393000,352000,-41000
1023482,22,NA,352000,352000,0
1023482,23,NA,352000,352000,0
1023482,24,NA,352000,352000,0
1023486,1,NA,272000,272000,0
1023486,2,NA,272000,272000,0
1023486,3,NA,272000,272000,0
1023486,4,NA,272000,272000,0
1023486,5,NA,272000,272000,0
1023486,6,NA,272000,272000,0
1023486,7,NA,272000,272000,0
1023486,8,NA,272000,272000,0
1023486,9,NA,272000,272000,0
1023486,10,NA,272000,272000,0
1023486,11,NA,272000,272000,0
1023486,12,NA,272000,272000,0
1023486,13,NA,272000,272000,0
1023486,14,NA,272000,272000,0
1023486,15,NA,272000,272000,0
1023486,16,NA,272000,272000,0
1023486,17,NA,272000,272000,0
1023486,18,NA,272000,272000,0
1023486,19,NA,272000,272000,0
1023486,20,NA,272000,272000,0
1023486,21,NA,272000,272000,0
1023486,22,NA,272000,272000,0
1023486,23,NA,272000,272000,0
1023486,24,NA,272000,272000,0
1023487,1,NA,252000,252000,0
1023487,2,NA,252000,252000,0
1023487,3,NA,252000,252000,0
1023487,4,NA,252000,252000,0
1023487,5,NA,252000,252000,0
1023487,6,NA,252000,252000,0
1023487,7,NA,252000,252000,0
1023487,8,NA,252000,252000,0
1023487,9,NA,252000,252000,0
1023487,10,NA,252000,252000,0
1023487,11,NA,252000,252000,0
1023487,12,NA,252000,252000,0
1023487,13,NA,252000,252000,0
1023487,14,NA,252000,252000,0
1023487,15,NA,252000,252000,0
1023487,16,NA,252000,252000,0
1023487,17,NA,252000,252000,0
1023487,18,NA,252000,252000,0
1023487,19,NA,252000,252000,0
1023487,20,NA,252000,252000,0
1023487,21,NA,252000,252000,0
1023487,22,NA,252000,252000,0
1023487,23,NA,252000,252000,0
1023487,24,NA,252000,252000,0
1023489,1,NA,200000,200000,0
1023489,2,NA,200000,200000,0
1023489,3,NA,200000,200000,0
1023489,4,NA,200000,200000,0
1023489,5,NA,200000,200000,0
1023489,6,NA,200000,200000,0
1023489,7,NA,200000,200000,0
1023489,8,NA,200000,200000,0
1023489,9,NA,200000,200000,0
1023489,10,NA,200000,200000,0
1023489,11,NA,200000,200000,0
1023489,12,NA,200000,200000,0
1023489,13,NA,200000,200000,0
1023489,14,NA,200000,200000,0
1023489,15,NA,200000,200000,0
1023489,16,NA,200000,200000,0
1023489,17,NA,200000,200000,0
1023489,18,NA,200000,200000,0
1023489,19,NA,200000,200000,0
1023489,20,NA,200000,200000,0
1023489,21,NA,200000,200000,0
1023489,22,NA,200000,200000,0
1023489,23,NA,200000,200000,0
1023489,24,NA,200000,200000,0
1023495,1,44,280000,289000,9000
1023495,2,77,289000,327000,38000
1023495,3,56,327000,366000,39000
1023495,4,54,366000,397000,31000
1023495,5,49,397000,417000,20000
1023495,6,75,417000,445000,28000
1023495,7,66,445000,468000,23000
1023495,8,86,468000,504000,36000
1023495,9,59,504000,525000,21000
1023495,10,32,525000,515000,-10000
1023495,11,40,515000,491000,-24000
1023495,12,NA,491000,491000,0
1023495,13,NA,491000,491000,0
1023495,14,NA,491000,491000,0
1023495,15,NA,491000,491000,0
1023495,16,NA,491000,491000,0
1023495,17,NA,491000,491000,0
1023495,18,NA,491000,491000,0
1023495,19,61,491000,476000,-15000
1023495,20,53,476000,462000,-14000
1023495,21,87,462000,479000,17000
1023495,22,40,479000,481000,2000
1023495,23,51,481000,479000,-2000
1023495,24,59,479000,476000,-3000
1023496,1,38,200000,211000,11000
1023496,2,34,211000,226000,15000
1023496,3,54,226000,256000,30000
1023496,4,48,256000,288000,32000
1023496,5,56,288000,322000,34000
1023496,6,NA,322000,322000,0
1023496,7,NA,322000,322000,0
1023496,8,NA,322000,322000,0
1023496,9,NA,322000,322000,0
1023496,10,34,322000,338000,16000
1023496,11,34,338000,341000,3000
1023496,12,65,341000,358000,17000
1023496,13,11,358000,344000,-14000
1023496,14,NA,344000,344000,0
1023496,15,40,344000,335000,-9000
1023496,16,71,335000,352000,17000
1023496,17,44,352000,365000,13000
1023496,18,41,365000,370000,5000
1023496,19,47,370000,378000,8000
1023496,20,55,378000,388000,10000
1023496,21,51,388000,395000,7000
1023496,22,50,395000,402000,7000
1023496,23,59,402000,415000,13000
1023496,24,51,415000,421000,6000
1023498,1,NA,248000,248000,0
1023498,2,NA,248000,248000,0
1023498,3,NA,248000,248000,0
1023498,4,NA,248000,248000,0
1023498,5,NA,248000,248000,0
1023498,6,NA,248000,248000,0
1023498,7,NA,248000,248000,0
1023498,8,NA,248000,248000,0
1023498,9,NA,248000,248000,0
1023498,10,NA,248000,248000,0
1023498,11,NA,248000,248000,0
1023498,12,NA,248000,248000,0
1023498,13,NA,248000,248000,0
1023498,14,NA,248000,248000,0
1023498,15,NA,248000,248000,0
1023498,16,NA,248000,248000,0
1023498,17,NA,248000,248000,0
1023498,18,NA,248000,248000,0
1023498,19,NA,248000,248000,0
1023498,20,NA,248000,248000,0
1023498,21,NA,248000,248000,0
1023498,22,NA,248000,248000,0
1023498,23,NA,248000,248000,0
1023498,24,NA,248000,248000,0
1023500,1,NA,290000,290000,0
1023500,2,NA,290000,290000,0
1023500,3,NA,290000,290000,0
1023500,4,47,290000,299000,9000
1023500,5,29,299000,301000,2000
1023500,6,57,301000,319000,18000
1023500,7,0,319000,302000,-17000
1023500,8,66,302000,313000,11000
1023500,9,94,313000,360000,47000
1023500,10,90,360000,423000,63000
1023500,11,72,423000,478000,55000
1023500,12,68,478000,520000,42000
1023500,13,NA,520000,520000,0
1023500,14,75,520000,553000,33000
1023500,15,36,553000,545000,-8000
1023500,16,45,545000,523000,-22000
1023500,17,52,523000,500000,-23000
1023500,18,46,500000,476000,-24000
1023500,19,11,476000,430000,-46000
1023500,20,47,430000,402000,-28000
1023500,21,57,402000,393000,-9000
1023500,22,50,393000,391000,-2000
1023500,23,33,391000,383000,-8000
1023500,24,NA,383000,383000,0
1023502,1,NA,244000,244000,0
1023502,2,NA,244000,244000,0
1023502,3,NA,244000,244000,0
1023502,4,NA,244000,244000,0
1023502,5,NA,244000,244000,0
1023502,6,NA,244000,244000,0
1023502,7,NA,244000,244000,0
1023502,8,NA,244000,244000,0
1023502,9,NA,244000,244000,0
1023502,10,NA,244000,244000,0
1023502,11,NA,244000,244000,0
1023502,12,NA,244000,244000,0
1023502,13,NA,244000,244000,0
1023502,14,NA,244000,244000,0
1023502,15,NA,244000,244000,0
1023502,16,NA,244000,244000,0
1023502,17,NA,244000,244000,0
1023502,18,NA,244000,244000,0
1023502,19,NA,244000,244000,0
1023502,20,NA,244000,244000,0
1023502,21,NA,244000,244000,0
1023502,22,NA,244000,244000,0
1023502,23,NA,244000,244000,0
1023502,24,NA,244000,244000,0
1023517,1,59,298000,316000,18000
1023517,2,90,316000,369000,53000
1023517,3,71,369000,424000,55000
1023517,4,76,424000,477000,53000
1023517,5,94,477000,534000,57000
1023517,6,66,534000,568000,34000
1023517,7,115,568000,618000,50000
1023517,8,61,618000,639000,21000
1023517,9,109,639000,672000,33000
1023517,10,127,672000,723000,51000
1023517,11,46,723000,726000,3000
1023517,12,NA,726000,726000,0
1023517,13,74,726000,715000,-11000
1023517,14,71,715000,702000,-13000
1023517,15,80,702000,686000,-16000
1023517,16,95,686000,685000,-1000
1023517,17,113,685000,712000,27000
1023517,18,82,712000,728000,16000
1023517,19,63,728000,722000,-6000
1023517,20,NA,722000,722000,0
1023517,21,NA,722000,722000,0
1023517,22,NA,722000,722000,0
1023517,23,NA,722000,722000,0
1023517,24,NA,722000,722000,0
1023518,1,118,296000,358000,62000
1023518,2,127,358000,466000,108000
1023518,3,109,466000,577000,111000
1023518,4,119,577000,680000,103000
1023518,5,96,680000,748000,68000
1023518,6,47,748000,751000,3000
1023518,7,126,751000,770000,19000
1023518,8,98,770000,784000,14000
1023518,9,81,784000,782000,-2000
1023518,10,112,782000,795000,13000
1023518,11,82,795000,797000,2000
1023518,12,64,797000,772000,-25000
1023518,13,92,772000,756000,-16000
1023518,14,98,756000,758000,2000
1023518,15,NA,758000,758000,0
1023518,16,106,758000,769000,11000
1023518,17,52,769000,749000,-20000
1023518,18,112,749000,755000,6000
1023518,19,116,755000,777000,22000
1023518,20,98,777000,794000,17000
1023518,21,53,794000,775000,-19000
1023518,22,110,775000,778000,3000
1023518,23,129,778000,801000,23000
1023518,24,94,801000,811000,10000
1023530,1,NA,262000,262000,0
1023530,2,NA,262000,262000,0
1023530,3,NA,262000,262000,0
1023530,4,NA,262000,262000,0
1023530,5,NA,262000,262000,0
1023530,6,NA,262000,262000,0
1023530,7,NA,262000,262000,0
1023530,8,NA,262000,262000,0
1023530,9,NA,262000,262000,0
1023530,10,NA,262000,262000,0
1023530,11,NA,262000,262000,0
1023530,12,NA,262000,262000,0
1023530,13,NA,262000,262000,0
1023530,14,NA,262000,262000,0
1023530,15,NA,262000,262000,0
1023530,16,NA,262000,262000,0
1023530,17,NA,262000,262000,0
1023530,18,NA,262000,262000,0
1023530,19,NA,262000,262000,0
1023530,20,NA,262000,262000,0
1023530,21,NA,262000,262000,0
1023530,22,NA,262000,262000,0
1023530,23,NA,262000,262000,0
1023530,24,NA,262000,262000,0
1023531,1,NA,210000,210000,0
1023531,2,NA,210000,210000,0
1023531,3,NA,210000,210000,0
1023531,4,NA,210000,210000,0
1023531,5,NA,210000,210000,0
1023531,6,NA,210000,210000,0
1023531,7,NA,210000,210000,0
1023531,8,NA,210000,210000,0
1023531,9,NA,210000,210000,0
1023531,10,NA,210000,210000,0
1023531,11,NA,210000,210000,0
1023531,12,NA,210000,210000,0
1023531,13,NA,210000,210000,0
1023531,14,NA,210000,210000,0
1023531,15,NA,210000,210000,0
1023531,16,NA,210000,210000,0
1023531,17,NA,210000,210000,0
1023531,18,NA,210000,210000,0
1023531,19,NA,210000,210000,0
1023531,20,NA,210000,210000,0
1023531,21,NA,210000,210000,0
1023531,22,NA,210000,210000,0
1023531,23,NA,210000,210000,0
1023531,24,NA,210000,210000,0
1023533,1,NA,238000,238000,0
1023533,2,NA,238000,238000,0
1023533,3,NA,238000,238000,0
1023533,4,NA,238000,238000,0
1023533,5,NA,238000,238000,0
1023533,6,NA,238000,238000,0
1023533,7,NA,238000,238000,0
1023533,8,NA,238000,238000,0
1023533,9,NA,238000,238000,0
1023533,10,NA,238000,238000,0
1023533,11,NA,238000,238000,0
1023533,12,NA,238000,238000,0
1023533,13,NA,238000,238000,0
1023533,14,NA,238000,238000,0
1023533,15,NA,238000,238000,0
1023533,16,NA,238000,238000,0
1023533,17,NA,238000,238000,0
1023533,18,NA,238000,238000,0
1023533,19,NA,238000,238000,0
1023533,20,NA,238000,238000,0
1023533,21,NA,238000,238000,0
1023533,22,NA,238000,238000,0
1023533,23,NA,238000,238000,0
1023533,24,NA,238000,238000,0
1023534,1,NA,202000,202000,0
1023534,2,NA,202000,202000,0
1023534,3,NA,202000,202000,0
1023534,4,NA,202000,202000,0
1023534,5,NA,202000,202000,0
1023534,6,NA,202000,202000,0
1023534,7,NA,202000,202000,0
1023534,8,NA,202000,202000,0
1023534,9,NA,202000,202000,0
1023534,10,NA,202000,202000,0
1023534,11,NA,202000,202000,0
1023534,12,NA,202000,202000,0
1023534,13,NA,202000,202000,0
1023534,14,NA,202000,202000,0
1023534,15,NA,202000,202000,0
1023534,16,NA,202000,202000,0
1023534,17,NA,202000,202000,0
1023534,18,NA,202000,202000,0
1023534,19,NA,202000,202000,0
1023534,20,NA,202000,202000,0
1023534,21,NA,202000,202000,0
1023534,22,NA,202000,202000,0
1023534,23,NA,202000,202000,0
1023534,24,NA,202000,202000,0
1023537,1,NA,286000,286000,0
1023537,2,NA,286000,286000,0
1023537,3,NA,286000,286000,0
1023537,4,NA,286000,286000,0
1023537,5,NA,286000,286000,0
1023537,6,NA,286000,286000,0
1023537,7,NA,286000,286000,0
1023537,8,NA,286000,286000,0
1023537,9,36,286000,287000,1000
1023537,10,NA,287000,287000,0
1023537,11,NA,287000,287000,0
1023537,12,NA,287000,287000,0
1023537,13,NA,287000,287000,0
1023537,14,NA,287000,287000,0
1023537,15,NA,287000,287000,0
1023537,16,NA,287000,287000,0
1023537,17,NA,287000,287000,0
1023537,18,NA,287000,287000,0
1023537,19,NA,287000,287000,0
1023537,20,NA,287000,287000,0
1023537,21,NA,287000,287000,0
1023537,22,NA,287000,287000,0
1023537,23,NA,287000,287000,0
1023537,24,NA,287000,287000,0
1023542,1,NA,200000,200000,0
1023542,2,NA,200000,200000,0
1023542,3,NA,200000,200000,0
1023542,4,NA,200000,200000,0
1023542,5,NA,200000,200000,0
1023542,6,NA,200000,200000,0
1023542,7,NA,200000,200000,0
1023542,8,NA,200000,200000,0
1023542,9,NA,200000,200000,0
1023542,10,NA,200000,200000,0
1023542,11,NA,200000,200000,0
1023542,12,NA,200000,200000,0
1023542,13,NA,200000,200000,0
1023542,14,NA,200000,200000,0
1023542,15,NA,200000,200000,0
1023542,16,NA,200000,200000,0
1023542,17,NA,200000,200000,0
1023542,18,NA,200000,200000,0
1023542,19,NA,200000,200000,0
1023542,20,NA,200000,200000,0
1023542,21,NA,200000,200000,0
1023542,22,NA,200000,200000,0
1023542,23,NA,200000,200000,0
1023542,24,18,200000,200000,0
1023544,1,NA,250000,250000,0
1023544,2,NA,250000,250000,0
1023544,3,NA,250000,250000,0
1023544,4,NA,250000,250000,0
1023544,5,NA,250000,250000,0
1023544,6,NA,250000,250000,0
1023544,7,NA,250000,250000,0
1023544,8,NA,250000,250000,0
1023544,9,NA,250000,250000,0
1023544,10,NA,250000,250000,0
1023544,11,NA,250000,250000,0
1023544,12,NA,250000,250000,0
1023544,13,NA,250000,250000,0
1023544,14,NA,250000,250000,0
1023544,15,NA,250000,250000,0
1023544,16,NA,250000,250000,0
1023544,17,NA,250000,250000,0
1023544,18,NA,250000,250000,0
1023544,19,NA,250000,250000,0
1023544,20,NA,250000,250000,0
1023544,21,NA,250000,250000,0
1023544,22,NA,250000,250000,0
1023544,23,NA,250000,250000,0
1023544,24,NA,250000,250000,0
1023547,1,NA,240000,240000,0
1023547,2,NA,240000,240000,0
1023547,3,NA,240000,240000,0
1023547,4,NA,240000,240000,0
1023547,5,NA,240000,240000,0
1023547,6,NA,240000,240000,0
1023547,7,NA,240000,240000,0
1023547,8,NA,240000,240000,0
1023547,9,NA,240000,240000,0
1023547,10,NA,240000,240000,0
1023547,11,NA,240000,240000,0
1023547,12,NA,240000,240000,0
1023547,13,NA,240000,240000,0
1023547,14,NA,240000,240000,0
1023547,15,NA,240000,240000,0
1023547,16,NA,240000,240000,0
1023547,17,NA,240000,240000,0
1023547,18,NA,240000,240000,0
1023547,19,NA,240000,240000,0
1023547,20,NA,240000,240000,0
1023547,21,NA,240000,240000,0
1023547,22,NA,240000,240000,0
1023547,23,NA,240000,240000,0
1023547,24,NA,240000,240000,0
1023680,1,NA,228000,228000,0
1023680,2,NA,228000,228000,0
1023680,3,NA,228000,228000,0
1023680,4,NA,228000,228000,0
1023680,5,NA,228000,228000,0
1023680,6,NA,228000,228000,0
1023680,7,NA,228000,228000,0
1023680,8,NA,228000,228000,0
1023680,9,NA,228000,228000,0
1023680,10,NA,228000,228000,0
1023680,11,NA,228000,228000,0
1023680,12,NA,228000,228000,0
1023680,13,NA,228000,228000,0
1023680,14,NA,228000,228000,0
1023680,15,NA,228000,228000,0
1023680,16,NA,228000,228000,0
1023680,17,NA,228000,228000,0
1023680,18,NA,228000,228000,0
1023680,19,NA,228000,228000,0
1023680,20,NA,228000,228000,0
1023680,21,NA,228000,228000,0
1023680,22,NA,228000,228000,0
1023680,23,74,228000,261000,33000
1023680,24,51,261000,298000,37000
1023708,1,NA,278000,278000,0
1023708,2,NA,278000,278000,0
1023708,3,NA,278000,278000,0
1023708,4,NA,278000,278000,0
1023708,5,NA,278000,278000,0
1023708,6,NA,278000,278000,0
1023708,7,NA,278000,278000,0
1023708,8,NA,278000,278000,0
1023708,9,NA,278000,278000,0
1023708,10,NA,278000,278000,0
1023708,11,NA,278000,278000,0
1023708,12,NA,278000,278000,0
1023708,13,NA,278000,278000,0
1023708,14,56,278000,296000,18000
1023708,15,49,296000,318000,22000
1023708,16,77,318000,361000,43000
1023708,17,37,361000,383000,22000
1023708,18,65,383000,408000,25000
1023708,19,76,408000,440000,32000
1023708,20,39,440000,449000,9000
1023708,21,36,449000,440000,-9000
1023708,22,24,440000,413000,-27000
1023708,23,38,413000,387000,-26000
1023708,24,56,387000,375000,-12000
1023743,1,NA,200000,200000,0
1023743,2,NA,200000,200000,0
1023743,3,NA,200000,200000,0
1023743,4,NA,200000,200000,0
1023743,5,NA,200000,200000,0
1023743,6,NA,200000,200000,0
1023743,7,NA,200000,200000,0
1023743,8,NA,200000,200000,0
1023743,9,NA,200000,200000,0
1023743,10,NA,200000,200000,0
1023743,11,NA,200000,200000,0
1023743,12,NA,200000,200000,0
1023743,13,NA,200000,200000,0
1023743,14,NA,200000,200000,0
1023743,15,NA,200000,200000,0
1023743,16,NA,200000,200000,0
1023743,17,NA,200000,200000,0
1023743,18,NA,200000,200000,0
1023743,19,NA,200000,200000,0
1023743,20,NA,200000,200000,0
1023743,21,NA,200000,200000,0
1023743,22,NA,200000,200000,0
1023743,23,NA,200000,200000,0
1023743,24,NA,200000,200000,0
1023784,1,29,200000,204000,4000
1023784,2,79,204000,248000,44000
1023784,3,55,248000,297000,49000
1023784,4,46,297000,335000,38000
1023784,5,38,335000,356000,21000
1023784,6,NA,356000,356000,0
1023784,7,NA,356000,356000,0
1023784,8,NA,356000,356000,0
1023784,9,64,356000,380000,24000
1023784,10,44,380000,389000,9000
1023784,11,39,389000,388000,-1000
1023784,12,NA,388000,388000,0
1023784,13,46,388000,387000,-1000
1023784,14,34,387000,380000,-7000
1023784,15,45,380000,373000,-7000
1023784,16,53,373000,376000,3000
1023784,17,71,376000,397000,21000
1023784,18,42,397000,408000,11000
1023784,19,76,408000,434000,26000
1023784,20,54,434000,451000,17000
1023784,21,41,451000,452000,1000
1023784,22,NA,452000,452000,0
1023784,23,NA,452000,452000,0
1023784,24,NA,452000,452000,0
1023785,1,NA,292000,292000,0
1023785,2,NA,292000,292000,0
1023785,3,NA,292000,292000,0
1023785,4,NA,292000,292000,0
1023785,5,NA,292000,292000,0
1023785,6,NA,292000,292000,0
1023785,7,NA,292000,292000,0
1023785,8,NA,292000,292000,0
1023785,9,NA,292000,292000,0
1023785,10,NA,292000,292000,0
1023785,11,NA,292000,292000,0
1023785,12,NA,292000,292000,0
1023785,13,NA,292000,292000,0
1023785,14,NA,292000,292000,0
1023785,15,NA,292000,292000,0
1023785,16,NA,292000,292000,0
1023785,17,NA,292000,292000,0
1023785,18,NA,292000,292000,0
1023785,19,NA,292000,292000,0
1023785,20,NA,292000,292000,0
1023785,21,65,292000,313000,21000
1023785,22,86,313000,363000,50000
1023785,23,43,363000,396000,33000
1023785,24,63,396000,424000,28000
1023787,1,NA,254000,254000,0
1023787,2,NA,254000,254000,0
1023787,3,NA,254000,254000,0
1023787,4,NA,254000,254000,0
1023787,5,NA,254000,254000,0
1023787,6,NA,254000,254000,0
1023787,7,NA,254000,254000,0
1023787,8,NA,254000,254000,0
1023787,9,NA,254000,254000,0
1023787,10,NA,254000,254000,0
1023787,11,NA,254000,254000,0
1023787,12,NA,254000,254000,0
1023787,13,NA,254000,254000,0
1023787,14,NA,254000,254000,0
1023787,15,NA,254000,254000,0
1023787,16,NA,254000,254000,0
1023787,17,NA,254000,254000,0
1023787,18,NA,254000,254000,0
1023787,19,NA,254000,254000,0
1023787,20,NA,254000,254000,0
1023787,21,NA,254000,254000,0
1023787,22,NA,254000,254000,0
1023787,23,NA,254000,254000,0
1023787,24,NA,254000,254000,0
1024096,1,NA,222000,222000,0
1024096,2,NA,222000,222000,0
1024096,3,NA,222000,222000,0
1024096,4,NA,222000,222000,0
1024096,5,NA,222000,222000,0
1024096,6,NA,222000,222000,0
1024096,7,NA,222000,222000,0
1024096,8,NA,222000,222000,0
1024096,9,NA,222000,222000,0
1024096,10,NA,222000,222000,0
1024096,11,NA,222000,222000,0
1024096,12,NA,222000,222000,0
1024096,13,NA,222000,222000,0
1024096,14,NA,222000,222000,0
1024096,15,NA,222000,222000,0
1024096,16,NA,222000,222000,0
1024096,17,NA,222000,222000,0
1024096,18,NA,222000,222000,0
1024096,19,NA,222000,222000,0
1024096,20,NA,222000,222000,0
1024096,21,NA,222000,222000,0
1024096,22,NA,222000,222000,0
1024096,23,NA,222000,222000,0
1024096,24,NA,222000,222000,0
1024666,1,NA,200000,200000,0
1024666,2,NA,200000,200000,0
1024666,3,NA,200000,200000,0
1024666,4,NA,200000,200000,0
1024666,5,NA,200000,200000,0
1024666,6,NA,200000,200000,0
1024666,7,NA,200000,200000,0
1024666,8,NA,200000,200000,0
1024666,9,NA,200000,200000,0
1024666,10,NA,200000,200000,0
1024666,11,NA,200000,200000,0
1024666,12,NA,200000,200000,0
1024666,13,NA,200000,200000,0
1024666,14,NA,200000,200000,0
1024666,15,NA,200000,200000,0
1024666,16,NA,200000,200000,0
1024666,17,NA,200000,200000,0
1024666,18,NA,200000,200000,0
1024666,19,NA,200000,200000,0
1024666,20,NA,200000,200000,0
1024666,21,NA,200000,200000,0
1024666,22,NA,200000,200000,0
1024666,23,33,200000,206000,6000
1024666,24,55,206000,231000,25000
1024686,1,NA,200000,200000,0
1024686,2,NA,200000,200000,0
1024686,3,NA,200000,200000,0
1024686,4,NA,200000,200000,0
1024686,5,NA,200000,200000,0
1024686,6,NA,200000,200000,0
1024686,7,NA,200000,200000,0
1024686,8,NA,200000,200000,0
1024686,9,NA,200000,200000,0
1024686,10,NA,200000,200000,0
1024686,11,NA,200000,200000,0
1024686,12,NA,200000,200000,0
1024686,13,NA,200000,200000,0
1024686,14,NA,200000,200000,0
1024686,15,NA,200000,200000,0
1024686,16,NA,200000,200000,0
1024686,17,NA,200000,200000,0
1024686,18,NA,200000,200000,0
1024686,19,NA,200000,200000,0
1024686,20,NA,200000,200000,0
1024686,21,NA,200000,200000,0
1024686,22,NA,200000,200000,0
1024686,23,NA,200000,200000,0
1024686,24,NA,200000,200000,0
1024939,1,NA,200000,200000,0
1024939,2,NA,200000,200000,0
1024939,3,NA,200000,200000,0
1024939,4,NA,200000,200000,0
1024939,5,NA,200000,200000,0
1024939,6,NA,200000,200000,0
1024939,7,NA,200000,200000,0
1024939,8,NA,200000,200000,0
1024939,9,NA,200000,200000,0
1024939,10,NA,200000,200000,0
1024939,11,NA,200000,200000,0
1024939,12,NA,200000,200000,0
1024939,13,NA,200000,200000,0
1024939,14,NA,200000,200000,0
1024939,15,NA,200000,200000,0
1024939,16,NA,200000,200000,0
1024939,17,NA,200000,200000,0
1024939,18,NA,200000,200000,0
1024939,19,NA,200000,200000,0
1024939,20,NA,200000,200000,0
1024939,21,NA,200000,200000,0
1024939,22,NA,200000,200000,0
1024939,23,NA,200000,200000,0
1024939,24,NA,200000,200000,0
1024982,1,NA,200000,200000,0
1024982,2,NA,200000,200000,0
1024982,3,NA,200000,200000,0
1024982,4,NA,200000,200000,0
1024982,5,NA,200000,200000,0
1024982,6,NA,200000,200000,0
1024982,7,NA,200000,200000,0
1024982,8,NA,200000,200000,0
1024982,9,NA,200000,200000,0
1024982,10,NA,200000,200000,0
1024982,11,56,200000,223000,23000
1024982,12,34,223000,244000,21000
1024982,13,NA,244000,244000,0
1024982,14,NA,244000,244000,0
1024982,15,NA,244000,244000,0
1024982,16,NA,244000,244000,0
1024982,17,47,244000,272000,28000
1024982,18,5,272000,268000,-4000
1024982,19,9,268000,248000,-20000
1024982,20,NA,248000,248000,0
1024982,21,NA,248000,248000,0
1024982,22,NA,248000,248000,0
1024982,23,NA,248000,248000,0
1024982,24,34,248000,234000,-14000
1025034,1,NA,200000,200000,0
1025034,2,NA,200000,200000,0
1025034,3,NA,200000,200000,0
1025034,4,NA,200000,200000,0
1025034,5,NA,200000,200000,0
1025034,6,NA,200000,200000,0
1025034,7,NA,200000,200000,0
1025034,8,19,200000,200000,0
1025034,9,42,200000,207000,7000
1025034,10,11,207000,205000,-2000
1025034,11,NA,205000,205000,0
1025034,12,NA,205000,205000,0
1025034,13,NA,205000,205000,0
1025034,14,NA,205000,205000,0
1025034,15,NA,205000,205000,0
1025034,16,NA,205000,205000,0
1025034,17,8,205000,200000,-5000
1025034,18,NA,200000,200000,0
1025034,19,NA,200000,200000,0
1025034,20,NA,200000,200000,0
1025034,21,NA,200000,200000,0
1025034,22,NA,200000,200000,0
1025034,23,NA,200000,200000,0
1025034,24,84,200000,226000,26000
1026850,1,76,707000,703000,-4000
1026850,2,42,703000,671000,-32000
1026850,3,109,671000,673000,2000
1026850,4,87,673000,680000,7000
1026850,5,66,680000,677000,-3000
1026850,6,61,677000,664000,-13000
1026850,7,91,664000,667000,3000
1026850,8,63,667000,654000,-13000
1026850,9,77,654000,646000,-8000
1026850,10,104,646000,662000,16000
1026850,11,124,662000,706000,44000
1026850,12,111,706000,752000,46000
1026850,13,114,752000,799000,47000
1026850,14,NA,799000,799000,0
1026850,15,112,799000,840000,41000
1026850,16,64,840000,837000,-3000
1026850,17,117,837000,842000,5000
1026850,18,79,842000,827000,-15000
1026850,19,91,827000,812000,-15000
1026850,20,67,812000,782000,-30000
1026850,21,52,782000,738000,-44000
1026850,22,129,738000,738000,0
1026850,23,32,738000,701000,-37000
1026850,24,91,701000,683000,-18000
1027021,1,NA,421000,421000,0
1027021,2,NA,421000,421000,0
1027021,3,8,421000,390000,-31000
1027021,4,NA,390000,390000,0
1027021,5,NA,390000,390000,0
1027021,6,NA,390000,390000,0
1027021,7,NA,390000,390000,0
1027021,8,NA,390000,390000,0
1027021,9,NA,390000,390000,0
1027021,10,NA,390000,390000,0
1027021,11,NA,390000,390000,0
1027021,12,NA,390000,390000,0
1027021,13,NA,390000,390000,0
1027021,14,NA,390000,390000,0
1027021,15,NA,390000,390000,0
1027021,16,NA,390000,390000,0
1027021,17,NA,390000,390000,0
1027021,18,NA,390000,390000,0
1027021,19,NA,390000,390000,0
1027021,20,NA,390000,390000,0
1027021,21,NA,390000,390000,0
1027021,22,NA,390000,390000,0
1027021,23,NA,390000,390000,0
1027021,24,NA,390000,390000,0
1027701,1,NA,218000,218000,0
1027701,2,NA,218000,218000,0
1027701,3,NA,218000,218000,0
1027701,4,NA,218000,218000,0
1027701,5,NA,218000,218000,0
1027701,6,NA,218000,218000,0
1027701,7,NA,218000,218000,0
1027701,8,NA,218000,218000,0
1027701,9,NA,218000,218000,0
1027701,10,NA,218000,218000,0
1027701,11,NA,218000,218000,0
1027701,12,NA,218000,218000,0
1027701,13,NA,218000,218000,0
1027701,14,NA,218000,218000,0
1027701,15,NA,218000,218000,0
1027701,16,NA,218000,218000,0
1027701,17,NA,218000,218000,0
1027701,18,NA,218000,218000,0
1027701,19,NA,218000,218000,0
1027701,20,NA,218000,218000,0
1027701,21,NA,218000,218000,0
1027701,22,NA,218000,218000,0
1027701,23,NA,218000,218000,0
1027701,24,NA,218000,218000,0
1027837,1,NA,200000,200000,0
1027837,2,NA,200000,200000,0
1027837,3,NA,200000,200000,0
1027837,4,NA,200000,200000,0
1027837,5,NA,200000,200000,0
1027837,6,NA,200000,200000,0
1027837,7,NA,200000,200000,0
1027837,8,NA,200000,200000,0
1027837,9,NA,200000,200000,0
1027837,10,NA,200000,200000,0
1027837,11,NA,200000,200000,0
1027837,12,NA,200000,200000,0
1027837,13,NA,200000,200000,0
1027837,14,NA,200000,200000,0
1027837,15,NA,200000,200000,0
1027837,16,NA,200000,200000,0
1027837,17,NA,200000,200000,0
1027837,18,NA,200000,200000,0
1027837,19,NA,200000,200000,0
1027837,20,NA,200000,200000,0
1027837,21,NA,200000,200000,0
1027837,22,NA,200000,200000,0
1027837,23,NA,200000,200000,0
1027837,24,NA,200000,200000,0
1027852,1,NA,200000,200000,0
1027852,2,NA,200000,200000,0
1027852,3,NA,200000,200000,0
1027852,4,NA,200000,200000,0
1027852,5,NA,200000,200000,0
1027852,6,NA,200000,200000,0
1027852,7,NA,200000,200000,0
1027852,8,NA,200000,200000,0
1027852,9,NA,200000,200000,0
1027852,10,NA,200000,200000,0
1027852,11,NA,200000,200000,0
1027852,12,NA,200000,200000,0
1027852,13,NA,200000,200000,0
1027852,14,NA,200000,200000,0
1027852,15,NA,200000,200000,0
1027852,16,NA,200000,200000,0
1027852,17,NA,200000,200000,0
1027852,18,NA,200000,200000,0
1027852,19,NA,200000,200000,0
1027852,20,NA,200000,200000,0
1027852,21,NA,200000,200000,0
1027852,22,NA,200000,200000,0
1027852,23,NA,200000,200000,0
1027852,24,NA,200000,200000,0
1027862,1,NA,200000,200000,0
1027862,2,NA,200000,200000,0
1027862,3,NA,200000,200000,0
1027862,4,NA,200000,200000,0
1027862,5,NA,200000,200000,0
1027862,6,NA,200000,200000,0
1027862,7,NA,200000,200000,0
1027862,8,NA,200000,200000,0
1027862,9,NA,200000,200000,0
1027862,10,NA,200000,200000,0
1027862,11,NA,200000,200000,0
1027862,12,NA,200000,200000,0
1027862,13,NA,200000,200000,0
1027862,14,NA,200000,200000,0
1027862,15,NA,200000,200000,0
1027862,16,NA,200000,200000,0
1027862,17,NA,200000,200000,0
1027862,18,NA,200000,200000,0
1027862,19,NA,200000,200000,0
1027862,20,NA,200000,200000,0
1027862,21,NA,200000,200000,0
1027862,22,NA,200000,200000,0
1027862,23,NA,200000,200000,0
1027862,24,NA,200000,200000,0
1027921,1,NA,258000,258000,0
1027921,2,NA,258000,258000,0
1027921,3,NA,258000,258000,0
1027921,4,NA,258000,258000,0
1027921,5,NA,258000,258000,0
1027921,6,NA,258000,258000,0
1027921,7,NA,258000,258000,0
1027921,8,NA,258000,258000,0
1027921,9,NA,258000,258000,0
1027921,10,NA,258000,258000,0
1027921,11,NA,258000,258000,0
1027921,12,NA,258000,258000,0
1027921,13,NA,258000,258000,0
1027921,14,NA,258000,258000,0
1027921,15,NA,258000,258000,0
1027921,16,NA,258000,258000,0
1027921,17,NA,258000,258000,0
1027921,18,NA,258000,258000,0
1027921,19,NA,258000,258000,0
1027921,20,NA,258000,258000,0
1027921,21,NA,258000,258000,0
1027921,22,NA,258000,258000,0
1027921,23,NA,258000,258000,0
1027921,24,NA,258000,258000,0
1027935,1,NA,266000,266000,0
1027935,2,NA,266000,266000,0
1027935,3,NA,266000,266000,0
1027935,4,NA,266000,266000,0
1027935,5,NA,266000,266000,0
1027935,6,NA,266000,266000,0
1027935,7,55,266000,282000,16000
1027935,8,46,282000,304000,22000
1027935,9,57,304000,333000,29000
1027935,10,102,333000,395000,62000
1027935,11,55,395000,438000,43000
1027935,12,80,438000,481000,43000
1027935,13,61,481000,508000,27000
1027935,14,NA,508000,508000,0
1027935,15,47,508000,513000,5000
1027935,16,83,513000,527000,14000
1027935,17,63,527000,535000,8000
1027935,18,48,535000,528000,-7000
1027935,19,53,528000,516000,-12000
1027935,20,59,516000,508000,-8000
1027935,21,74,508000,511000,3000
1027935,22,70,511000,520000,9000
1027935,23,76,520000,538000,18000
1027935,24,67,538000,549000,11000
1027959,1,NA,232000,232000,0
1027959,2,NA,232000,232000,0
1027959,3,NA,232000,232000,0
1027959,4,NA,232000,232000,0
1027959,5,NA,232000,232000,0
1027959,6,NA,232000,232000,0
1027959,7,NA,232000,232000,0
1027959,8,NA,232000,232000,0
1027959,9,NA,232000,232000,0
1027959,10,NA,232000,232000,0
1027959,11,NA,232000,232000,0
1027959,12,NA,232000,232000,0
1027959,13,NA,232000,232000,0
1027959,14,NA,232000,232000,0
1027959,15,NA,232000,232000,0
1027959,16,NA,232000,232000,0
1027959,17,NA,232000,232000,0
1027959,18,NA,232000,232000,0
1027959,19,NA,232000,232000,0
1027959,20,NA,232000,232000,0
1027959,21,NA,232000,232000,0
1027959,22,NA,232000,232000,0
1027959,23,NA,232000,232000,0
1027959,24,NA,232000,232000,0
1027965,1,NA,200000,200000,0
1027965,2,NA,200000,200000,0
1027965,3,NA,200000,200000,0
1027965,4,NA,200000,200000,0
1027965,5,NA,200000,200000,0
1027965,6,NA,200000,200000,0
1027965,7,28,200000,203000,3000
1027965,8,NA,203000,203000,0
1027965,9,NA,203000,203000,0
1027965,10,NA,203000,203000,0
1027965,11,NA,203000,203000,0
1027965,12,NA,203000,203000,0
1027965,13,NA,203000,203000,0
1027965,14,NA,203000,203000,0
1027965,15,NA,203000,203000,0
1027965,16,NA,203000,203000,0
1027965,17,NA,203000,203000,0
1027965,18,NA,203000,203000,0
1027965,19,NA,203000,203000,0
1027965,20,NA,203000,203000,0
1027965,21,NA,203000,203000,0
1027965,22,NA,203000,203000,0
1027965,23,33,203000,211000,8000
1027965,24,NA,211000,211000,0
1027971,1,NA,234000,234000,0
1027971,2,NA,234000,234000,0
1027971,3,NA,234000,234000,0
1027971,4,NA,234000,234000,0
1027971,5,NA,234000,234000,0
1027971,6,NA,234000,234000,0
1027971,7,NA,234000,234000,0
1027971,8,NA,234000,234000,0
1027971,9,NA,234000,234000,0
1027971,10,NA,234000,234000,0
1027971,11,NA,234000,234000,0
1027971,12,NA,234000,234000,0
1027971,13,NA,234000,234000,0
1027971,14,NA,234000,234000,0
1027971,15,NA,234000,234000,0
1027971,16,NA,234000,234000,0
1027971,17,NA,234000,234000,0
1027971,18,NA,234000,234000,0
1027971,19,NA,234000,234000,0
1027971,20,NA,234000,234000,0
1027971,21,NA,234000,234000,0
1027971,22,43,234000,244000,10000
1027971,23,26,244000,250000,6000
1027971,24,8,250000,237000,-13000
1028105,1,NA,200000,200000,0
1028105,2,NA,200000,200000,0
1028105,3,NA,200000,200000,0
1028105,4,NA,200000,200000,0
1028105,5,NA,200000,200000,0
1028105,6,NA,200000,200000,0
1028105,7,NA,200000,200000,0
1028105,8,NA,200000,200000,0
1028105,9,NA,200000,200000,0
1028105,10,NA,200000,200000,0
1028105,11,NA,200000,200000,0
1028105,12,NA,200000,200000,0
1028105,13,NA,200000,200000,0
1028105,14,NA,200000,200000,0
1028105,15,NA,200000,200000,0
1028105,16,NA,200000,200000,0
1028105,17,NA,200000,200000,0
1028105,18,NA,200000,200000,0
1028105,19,NA,200000,200000,0
1028105,20,NA,200000,200000,0
1028105,21,NA,200000,200000,0
1028105,22,NA,200000,200000,0
1028105,23,NA,200000,200000,0
1028105,24,NA,200000,200000,0
1029261,1,NA,200000,200000,0
1029261,2,NA,200000,200000,0
1029261,3,NA,200000,200000,0
1029261,4,NA,200000,200000,0
1029261,5,NA,200000,200000,0
1029261,6,NA,200000,200000,0
1029261,7,NA,200000,200000,0
1029261,8,NA,200000,200000,0
1029261,9,NA,200000,200000,0
1029261,10,NA,200000,200000,0
1029261,11,NA,200000,200000,0
1029261,12,51,200000,219000,19000
1029261,13,NA,219000,219000,0
1029261,14,NA,219000,219000,0
1029261,15,NA,219000,219000,0
1029261,16,NA,219000,219000,0
1029261,17,NA,219000,219000,0
1029261,18,NA,219000,219000,0
1029261,19,NA,219000,219000,0
1029261,20,NA,219000,219000,0
1029261,21,NA,219000,219000,0
1029261,22,54,219000,252000,33000
1029261,23,NA,252000,252000,0
1029261,24,NA,252000,252000,0
1029288,1,NA,200000,200000,0
1029288,2,NA,200000,200000,0
1029288,3,NA,200000,200000,0
1029288,4,NA,200000,200000,0
1029288,5,NA,200000,200000,0
1029288,6,NA,200000,200000,0
1029288,7,NA,200000,200000,0
1029288,8,NA,200000,200000,0
1029288,9,NA,200000,200000,0
1029288,10,NA,200000,200000,0
1029288,11,NA,200000,200000,0
1029288,12,NA,200000,200000,0
1029288,13,NA,200000,200000,0
1029288,14,NA,200000,200000,0
1029288,15,NA,200000,200000,0
1029288,16,NA,200000,200000,0
1029288,17,NA,200000,200000,0
1029288,18,NA,200000,200000,0
1029288,19,NA,200000,200000,0
1029288,20,NA,200000,200000,0
1029288,21,NA,200000,200000,0
1029288,22,NA,200000,200000,0
1029288,23,NA,200000,200000,0
1029288,24,NA,200000,200000,0
1029416,1,NA,200000,200000,0
1029416,2,NA,200000,200000,0
1029416,3,NA,200000,200000,0
1029416,4,NA,200000,200000,0
1029416,5,NA,200000,200000,0
1029416,6,NA,200000,200000,0
1029416,7,NA,200000,200000,0
1029416,8,NA,200000,200000,0
1029416,9,NA,200000,200000,0
1029416,10,NA,200000,200000,0
1029416,11,NA,200000,200000,0
1029416,12,NA,200000,200000,0
1029416,13,50,200000,218000,18000
1029416,14,NA,218000,218000,0
1029416,15,27,218000,233000,15000
1029416,16,71,233000,273000,40000
1029416,17,41,273000,304000,31000
1029416,18,55,304000,335000,31000
1029416,19,57,335000,363000,28000
1029416,20,42,363000,379000,16000
1029416,21,52,379000,390000,11000
1029416,22,NA,390000,390000,0
1029416,23,49,390000,397000,7000
1029416,24,49,397000,400000,3000
1029882,1,NA,200000,200000,0
1029882,2,NA,200000,200000,0
1029882,3,NA,200000,200000,0
1029882,4,NA,200000,200000,0
1029882,5,NA,200000,200000,0
1029882,6,NA,200000,200000,0
1029882,7,NA,200000,200000,0
1029882,8,NA,200000,200000,0
1029882,9,NA,200000,200000,0
1029882,10,NA,200000,200000,0
1029882,11,NA,200000,200000,0
1029882,12,NA,200000,200000,0
1029882,13,NA,200000,200000,0
1029882,14,NA,200000,200000,0
1029882,15,NA,200000,200000,0
1029882,16,NA,200000,200000,0
1029882,17,NA,200000,200000,0
1029882,18,NA,200000,200000,0
1029882,19,NA,200000,200000,0
1029882,20,NA,200000,200000,0
1029882,21,NA,200000,200000,0
1029882,22,NA,200000,200000,0
1029882,23,NA,200000,200000,0
1029882,24,NA,200000,200000,0
1029973,1,NA,200000,200000,0
1029973,2,NA,200000,200000,0
1029973,3,NA,200000,200000,0
1029973,4,NA,200000,200000,0
1029973,5,NA,200000,200000,0
1029973,6,NA,200000,200000,0
1029973,7,NA,200000,200000,0
1029973,8,NA,200000,200000,0
1029973,9,NA,200000,200000,0
1029973,10,NA,200000,200000,0
1029973,11,NA,200000,200000,0
1029973,12,NA,200000,200000,0
1029973,13,NA,200000,200000,0
1029973,14,NA,200000,200000,0
1029973,15,NA,200000,200000,0
1029973,16,NA,200000,200000,0
1029973,17,NA,200000,200000,0
1029973,18,NA,200000,200000,0
1029973,19,NA,200000,200000,0
1029973,20,NA,200000,200000,0
1029973,21,NA,200000,200000,0
1029973,22,NA,200000,200000,0
1029973,23,NA,200000,200000,0
1029973,24,NA,200000,200000,0
1030866,1,NA,200000,200000,0
1030866,2,NA,200000,200000,0
1030866,3,NA,200000,200000,0
1030866,4,NA,200000,200000,0
1030866,5,NA,200000,200000,0
1030866,6,NA,200000,200000,0
1030866,7,NA,200000,200000,0
1030866,8,NA,200000,200000,0
1030866,9,NA,200000,200000,0
1030866,10,NA,200000,200000,0
1030866,11,NA,200000,200000,0
1030866,12,NA,200000,200000,0
1030866,13,NA,200000,200000,0
1030866,14,NA,200000,200000,0
1030866,15,NA,200000,200000,0
1030866,16,NA,200000,200000,0
1030866,17,NA,200000,200000,0
1030866,18,NA,200000,200000,0
1030866,19,NA,200000,200000,0
1030866,20,NA,200000,200000,0
1030866,21,NA,200000,200000,0
1030866,22,NA,200000,200000,0
1030866,23,NA,200000,200000,0
1030866,24,NA,200000,200000,0
1031801,1,NA,200000,200000,0
1031801,2,NA,200000,200000,0
1031801,3,NA,200000,200000,0
1031801,4,NA,200000,200000,0
1031801,5,NA,200000,200000,0
1031801,6,NA,200000,200000,0
1031801,7,NA,200000,200000,0
1031801,8,NA,200000,200000,0
1031801,9,NA,200000,200000,0
1031801,10,NA,200000,200000,0
1031801,11,NA,200000,200000,0
1031801,12,NA,200000,200000,0
1031801,13,NA,200000,200000,0
1031801,14,NA,200000,200000,0
1031801,15,NA,200000,200000,0
1031801,16,NA,200000,200000,0
1031801,17,NA,200000,200000,0
1031801,18,NA,200000,200000,0
1031801,19,18,200000,200000,0
1031801,20,17,200000,200000,0
1031801,21,NA,200000,200000,0
1031801,22,NA,200000,200000,0
1031801,23,NA,200000,200000,0
1031801,24,NA,200000,200000,0
1031829,1,NA,200000,200000,0
1031829,2,NA,200000,200000,0
1031829,3,NA,200000,200000,0
1031829,4,NA,200000,200000,0
1031829,5,NA,200000,200000,0
1031829,6,NA,200000,200000,0
1031829,7,NA,200000,200000,0
1031829,8,NA,200000,200000,0
1031829,9,NA,200000,200000,0
1031829,10,NA,200000,200000,0
1031829,11,NA,200000,200000,0
1031829,12,NA,200000,200000,0
1031829,13,NA,200000,200000,0
1031829,14,NA,200000,200000,0
1031829,15,NA,200000,200000,0
1031829,16,NA,200000,200000,0
1031829,17,NA,200000,200000,0
1031829,18,NA,200000,200000,0
1031829,19,NA,200000,200000,0
1031829,20,NA,200000,200000,0
1031829,21,NA,200000,200000,0
1031829,22,NA,200000,200000,0
1031829,23,NA,200000,200000,0
1031829,24,77,200000,236000,36000
1032966,1,NA,200000,200000,0
1032966,2,NA,200000,200000,0
1032966,3,NA,200000,200000,0
1032966,4,NA,200000,200000,0
1032966,5,NA,200000,200000,0
1032966,6,NA,200000,200000,0
1032966,7,NA,200000,200000,0
1032966,8,NA,200000,200000,0
1032966,9,10,200000,200000,0
1032966,10,10,200000,200000,0
1032966,11,45,200000,200000,0
1032966,12,33,200000,200000,0
1032966,13,24,200000,204000,4000
1032966,14,NA,204000,204000,0
1032966,15,NA,204000,204000,0
1032966,16,34,204000,219000,15000
1032966,17,9,219000,216000,-3000
1032966,18,22,216000,208000,-8000
1032966,19,NA,208000,208000,0
1032966,20,NA,208000,208000,0
1032966,21,25,208000,203000,-5000
1032966,22,73,203000,234000,31000
1032966,23,65,234000,280000,46000
1032966,24,47,280000,319000,39000
